government-organisation	name	website	type	start-date	end date
academy-for-justice-commissioning	Academy for Social Justice Commissioning	government/organisations/academy-for-justice-commissioning	Other		
acas	"Advisory, Conciliation and Arbitration Service"	government/organisations/acas	Executive non-departmental public body		
accelerated-access-review	Accelerated Access Review	government/organisations/accelerated-access-review	Other		
administration-of-radioactive-substances-advisory-committee	Administration of Radioactive Substances Advisory Committee	government/organisations/administration-of-radioactive-substances-advisory-committee	Advisory non-departmental public body		
administrative-court	Administrative Court	courts-tribunals/administrative-court	Court		
administrative-justice-and-tribunals-council	Administrative Justice and Tribunals Council	government/organisations/administrative-justice-and-tribunals-council	Advisory non-departmental public body		19/08/2013
administrative-justice-and-tribunals-council-welsh-committee	Administrative Justice and Tribunals Council Welsh Committee	government/organisations/administrative-justice-and-tribunals-council-welsh-committee	Other		
admiralty-court	Admiralty Court	courts-tribunals/admiralty-court	Court		
adult-learning-inspectorate	Adult Learning Inspectorate	government/organisations/adult-learning-inspectorate	Other		2007-04
advantage-west-midlands	Advantage West Midlands	government/organisations/advantage-west-midlands	Executive agency		
advisory-committee-on-animal-feedingstuffs	Advisory Committee on Animal Feedingstuffs	government/organisations/advisory-committee-on-animal-feedingstuffs	Advisory non-departmental public body		
advisory-committee-on-business-appointments	Advisory Committee on Business Appointments	government/organisations/advisory-committee-on-business-appointments	Advisory non-departmental public body		
advisory-committee-on-clinical-excellence-awards	Advisory Committee on Clinical Excellence Awards	government/organisations/advisory-committee-on-clinical-excellence-awards	Advisory non-departmental public body		
advisory-committee-on-conscientious-objectors	Advisory Committee on Conscientious Objectors	government/organisations/advisory-committee-on-conscientious-objectors	Advisory non-departmental public body		
advisory-committee-on-novel-foods-and-processes	Advisory Committee on Novel Foods and Processes	government/organisations/advisory-committee-on-novel-foods-and-processes	Advisory non-departmental public body		
advisory-committee-on-pesticides	Advisory Committee on Pesticides	government/organisations/advisory-committee-on-pesticides	Advisory non-departmental public body		2015-03
advisory-committee-on-releases-to-the-environment	Advisory Committee on Releases to the Environment	government/organisations/advisory-committee-on-releases-to-the-environment	Advisory non-departmental public body		
advisory-committee-on-the-microbiological-safety-of-food	Advisory Committee on the Microbiological Safety of Food	government/organisations/advisory-committee-on-the-microbiological-safety-of-food	Advisory non-departmental public body		
advisory-committees-on-justices-of-the-peace	Advisory Committees on Justices of the Peace	government/organisations/advisory-committees-on-justices-of-the-peace	Advisory non-departmental public body		
advisory-council-on-the-misuse-of-drugs	Advisory Council on the Misuse of Drugs	government/organisations/advisory-council-on-the-misuse-of-drugs	Advisory non-departmental public body		
advisory-group-on-military-medicine	Advisory Group on Military Medicine	government/organisations/advisory-group-on-military-medicine	Other		
advisory-panel-on-public-sector-information	Advisory Panel on Public Sector Information	government/organisations/advisory-panel-on-public-sector-information	Advisory non-departmental public body		2015-10
agri-food-and-biosciences-institute	Agri-Food and Biosciences Institute (Northern Ireland)	government/organisations/agri-food-and-biosciences-institute	Executive non-departmental public body		
agricultural-dwelling-house-advisory-committees-x16	Agricultural Dwelling House Advisory Committees (x16)	government/organisations/agricultural-dwelling-house-advisory-committees-x16	Advisory non-departmental public body		
agricultural-wages-committee-x13	Agricultural Wages Committee	government/organisations/agricultural-wages-committee-x13	Executive non-departmental public body		
agriculture-and-horticulture-development-board	Agriculture and Horticulture Development Board	government/organisations/agriculture-and-horticulture-development-board	Executive non-departmental public body		
air-accidents-investigation-branch	Air Accidents Investigation Branch	government/organisations/air-accidents-investigation-branch	Other		
airports-commission	Airports Commission	government/organisations/airports-commission	Other		2015-07
alcohol-education-and-research-council	Alcohol Education and Research Council	government/organisations/alcohol-education-and-research-council	Other		28/03/2011
ancient-monuments-board-for-scotland	Ancient Monuments Board for Scotland	government/organisations/ancient-monuments-board-for-Scotland	Other		closed
animal-and-plant-health-agency	Animal and Plant Health Agency	government/organisations/animal-and-plant-health-agency	Executive agency		
animal-health	Animal Health	government/organisations/animal-health	Executive agency		01/04/2011
animal-health-and-veterinary-laboratories-agency	Animal Health and Veterinary Laboratories Agency	government/organisations/animal-health-and-veterinary-laboratories-agency	Executive agency		01/04/2011
animal-procedures-committee	Animal Procedures Committee	government/organisations/animal-procedures-committee	Other		2012-12
animals-in-science-committee	Animals in Science Committee	government/organisations/animals-in-science-committee	Advisory non-departmental public body		
appeals-service-agency	Appeals Service Agency	government/organisations/appeals-service-agency	Executive agency		
architects-registration-board	Architects Registration Board	government/organisations/architects-registration-board	Public corporation		
armagh-observatory-and-planetarium	Armagh Observatory and Planetarium	government/organisations/armagh-observatory-and-planetarium	Other		
armed-forces-pay-review-body	Armed Forces' Pay Review Body	government/organisations/armed-forces-pay-review-body	Advisory non-departmental public body		
armed-forces-personnel-administration-agency	Armed Forces Personnel Administration Agency	government/organisations/armed-forces-personnel-administration-agency	Executive agency		2007-04
army-base-repair-organisation	Army Base Repair Organisation	government/organisations/army-base-repair-organisation	Executive agency		01/04/2008
arts-and-humanities-research-council	Arts and Humanities Research Council	government/organisations/arts-and-humanities-research-council	Executive non-departmental public body		
arts-council-england	Arts Council England	government/organisations/arts-council-england	Executive non-departmental public body		
arts-council-of-northern-ireland	Arts Council of Northern Ireland	government/organisations/arts-council-of-northern-Ireland	Executive agency		
arts-council-of-wales	Arts Council of Wales	government/organisations/arts-council-of-wales	Other		
ashington-education-action-zone	Ashington Education Action Zone	government/organisations/ashington-education-action-zone	Other		
asset-protection-agency	Asset Protection Agency	government/organisations/asset-protection-agency	Executive agency		31/12/2012
assets-recovery-agency	Assets Recovery Agency	government/organisations/assets-recovery-agency	Executive agency		01/04/2008
attorney-generals-office	Attorney General's Office	government/organisations/attorney-generals-office	Ministerial department		
audit-commission	Audit Commission	government/organisations/audit-commission	Public corporation		31/03/2015
azelle-rodney-inquiry	Azelle Rodney Inquiry	government/organisations/azelle-rodney-inquiry	Other		
baha-mousa-inquiry	Baha Mousa Inquiry	government/organisations/baha-mousa-inquiry	Other		
bank-of-england	Bank of England	government/organisations/bank-of-england	Other		
bankruptcy-court	Bankruptcy Court	courts-tribunals/bankruptcy-court	Court		
barker-review-of-land-use-planning	Barker Review of Land Use Planning	government/organisations/barker-review-of-land-use-planning	Other		
barrow-education-action-zone	Barrow Education Action Zone	government/organisations/barrow-education-action-zone	Other		
bbc	BBC	government/organisations/bbc	Public corporation		
bbc-world-service	BBC World Service	government/organisations/bbc-world-service	Public corporation		
bedford-education-action-zone	Bedford Education Action Zone	government/organisations/bedford-education-action-zone	Other		
behavioural-insights-team	Behavioural Insights Team	government/organisations/behavioural-insights-team	Other		05/02/2014
better-regulation-delivery-office	Better Regulation Delivery Office	government/organisations/better-regulation-delivery-office	Other		
big-lottery-fund	Big Lottery Fund	government/organisations/big-lottery-fund	Executive non-departmental public body		
billy-wright-inquiry	Billy Wright Inquiry	government/organisations/billy-wright-inquiry	Other		
biometrics-commissioner	Biometrics Commissioner	government/organisations/biometrics-commissioner	Other		
biotechnology-biological-sciences-research-council	Biotechnology and Biological Sciences Research Council	government/organisations/biotechnology-biological-sciences-research-council	Executive non-departmental public body		
bloody-sunday-inquiry	Bloody Sunday Inquiry	government/organisations/bloody-sunday-inquiry	Other		
board-of-banking-supervision	Board of Banking Supervision	government/organisations/board-of-banking-supervision	Other		
board-of-inland-revenue	Board of Inland Revenue	government/organisations/board-of-inland-revenue	Other		
board-of-trustees-of-the-royal-botanic-gardens-kew	Board of Trustees of the Royal Botanic Gardens Kew	government/organisations/board-of-trustees-of-the-royal-botanic-gardens-kew	Executive non-departmental public body		
bolton-education-action-zone	Bolton Education Action Zone	government/organisations/bolton-education-action-zone	Other		
bona-vacantia	Bona Vacantia	government/organisations/bona-vacantia	Sub-organisation		
border-force	Border Force	government/organisations/border-force	Sub-organisation		
boundary-commission-for-england	Boundary Commission for England	government/organisations/boundary-commission-for-england	Advisory non-departmental public body		
boundary-commission-for-northern-ireland	Boundary Commission for Northern Ireland	government/organisations/boundary-commission-for-northern-Ireland	Advisory non-departmental public body		
boundary-commission-for-scotland	Boundary Commission for Scotland	government/organisations/boundary-commission-for-Scotland	Advisory non-departmental public body		
boundary-commission-for-wales	Boundary Commission for Wales	government/organisations/boundary-commission-for-wales	Advisory non-departmental public body		
brb-residuary-ltd	BRB (Residuary) Ltd	government/organisations/brb-residuary-ltd	Public corporation		
bridgwater-education-action-zone	Bridgwater Education Action Zone	government/organisations/bridgwater-education-action-zone	Other		
bristol-education-action-zone	Bristol Education Action Zone	government/organisations/bristol-education-action-zone	Other		
british-business-bank	British Business Bank	government/organisations/british-business-bank	Other		
british-cattle-movement-service	British Cattle Movement Service	government/organisations/british-cattle-movement-service	Sub-organisation		
british-council	British Council	government/organisations/british-council	Executive non-departmental public body		
british-educational-communications-and-technology-agency	British Educational Communications and Technology Agency	government/organisations/british-educational-communications-and-technology-agency	Executive agency		31/03/2011
british-film-institute	British Film Institute	government/organisations/british-film-institute	Executive non-departmental public body		
british-forces-post-office	British Forces Post Office	government/organisations/british-forces-post-office	Other		
british-hallmarking-council	British Hallmarking Council	government/organisations/british-hallmarking-council	Executive non-departmental public body		
british-library	British Library	government/organisations/british-library	Executive non-departmental public body		
british-museum	British Museum	government/organisations/british-museum	Executive non-departmental public body		
british-pharmacopoeia	British Pharmacopoeia Commission	government/organisations/british-pharmacopoeia	Advisory non-departmental public body		
british-potato-council	British Potato Council	government/organisations/british-potato-council	Other		01/04/2008
british-transport-police-authority	British Transport Police Authority	government/organisations/british-transport-police-authority	Executive non-departmental public body		
broadcasting-standards-commission	Broadcasting Standards Commission	government/organisations/broadcasting-standards-commission	Other		29/12/2003
broads-authority	Broads Authority	government/organisations/broads-authority	Other		
building-regulations-advisory-committee	Building Regulations Advisory Committee	government/organisations/building-regulations-advisory-committee	Advisory non-departmental public body		
building-research-establishment	Building Research Establishment	government/organisations/building-research-establishment	Executive agency		1997
business-development-service	Business Development Service	government/organisations/business-development-service	Other		01/04/2006
buying-solutions	Buying Solutions	government/organisations/buying-solutions	Other		2010-06
cabinet-office	Cabinet Office	government/organisations/cabinet-office	Ministerial department		
cabinet-office-board	Cabinet Office Board	government/organisations/cabinet-office-board	Sub-organisation		
camborne-pool-and-redruth-education-action-zone	"Camborne, Pool and Redruth Education Action Zone"	government/organisations/camborne-pool-and-redruth-education-action-zone	Other		
capacitybuilders	Capacitybuilders	government/organisations/capacitybuilders	Other		31/03/2011
capital-for-enterprise-ltd	Capital for Enterprise Limited	government/organisations/capital-for-enterprise-ltd	Executive non-departmental public body		
care-quality-commission	Care Quality Commission	government/organisations/care-quality-commission	Executive non-departmental public body		
careers-wales	Careers Wales	government/organisations/careers-wales	Other		
central-advisory-committee-on-compensation	Central Advisory Committee on Compensation	government/organisations/central-advisory-committee-on-compensation	Ad-hoc advisory group		
central-advisory-committee-on-pensions-and-compensation	Central Advisory Committee on Pensions and Compensation	government/organisations/central-advisory-committee-on-pensions-and-compensation	Advisory non-departmental public body		
central-arbitration-committee	Central Arbitration Committee	government/organisations/central-arbitration-committee	Tribunal non-departmental public body		
central-office-of-information	Central Office of Information	government/organisations/central-office-of-information	Other		30/12/2011
central-police-training-and-development-authority	Central Police Training and Development Authority	government/organisations/central-police-training-and-development-authority	Other		31/03/2007
central-science-laboratory	Central Science Laboratory	government/organisations/central-science-laboratory	Executive agency		31/03/2009
centre-for-defence-enterprise	Centre for Defence Enterprise	government/organisations/centre-for-defence-enterprise	Sub-organisation		
centre-for-environment-fisheries-and-aquaculture-science	"Centre for Environment, Fisheries and Aquaculture Science"	government/organisations/centre-for-environment-fisheries-and-aquaculture-science	Executive agency		
centre-for-the-protection-of-national-infrastructure	Centre for the Protection of National Infrastructure	government/organisations/centre-for-the-protection-of-national-infrastructure	Other		
certification-officer	Certification Officer	government/organisations/certification-officer	Other		
cesg	CESG	government/organisations/cesg	Sub-organisation		
chancery-division-of-the-high-court	Chancery Division of the High Court	courts-tribunals/chancery-division-of-the-high-court	Court		
channel-4	The Charity Commission	government/organisations/channel-4	Public corporation		
charity-commission	The Charity Commission	government/organisations/charity-commission	Non-ministerial department		
chemical-and-biological-defence-establishment	Chemical and Biological Defence Establishment	government/organisations/chemical-and-biological-defence-establishment	Other		
chevening-foundation	Chevening Scholarship Programme	government/organisations/chevening-foundation	Other		
chief-fire-and-rescue-adviser-unit	Chief Fire and Rescue Adviser	government/organisations/chief-fire-and-rescue-adviser-unit	Sub-organisation		
chief-inspector-of-the-uk-border-agency	Independent Chief Inspector of Borders and Immigration	government/organisations/chief-inspector-of-the-uk-border-agency	Independent monitoring body		
child-maintenance-and-enforcement-commission	Child Maintenance and Enforcement Commission	government/organisations/child-maintenance-and-enforcement-commission	Other		30/07/2012
children-and-family-court-advisory-and-support-service	Cafcass	government/organisations/children-and-family-court-advisory-and-support-service	Executive non-departmental public body		
childrens-workforce-development-council	Children's Workforce Development Council	government/organisations/childrens-workforce-development-council	Other		31/03/2012
civil-aviation-authority	Civil Aviation Authority	government/organisations/civil-aviation-authority	Public corporation		
civil-justice-council	Civil Justice Council	government/organisations/civil-justice-council	Advisory non-departmental public body		
civil-nuclear-constabulary	Civil Nuclear Constabulary	government/organisations/civil-nuclear-constabulary	Sub-organisation		
civil-nuclear-police-authority	Civil Nuclear Police Authority	government/organisations/civil-nuclear-police-authority	Executive non-departmental public body		
civil-procedure-rules-committee	Civil Procedure Rule Committee	government/organisations/civil-procedure-rules-committee	Advisory non-departmental public body		
civil-service	Civil Service	government/organisations/civil-service	Civil Service		
civil-service-board	Civil Service Board	government/organisations/civil-service-board	Sub-organisation		
civil-service-commission		government/organisations/civil-service-commission	Executive non-departmental public body		
civil-service-corporate-finance-profession-cfp	Government Corporate Finance Commission	government/organisations/civil-service-corporate-finance-profession-cfp	Sub-organisation		
civil-service-fast-stream	Civil Service Fast Stream	government/organisations/civil-service-fast-stream	Sub-organisation		
civil-service-fast-track-apprenticeship	Civil Service Fast Track Apprenticeship	government/organisations/civil-service-fast-track-apprenticeship	Sub-organisation		
civil-service-government-communication-service	Government Communication Service	government/organisations/civil-service-government-communication-service	Sub-organisation		
civil-service-government-economic-service	Government Economic Service	government/organisations/civil-service-government-economic-service	Sub-organisation		
civil-service-government-finance-profession	Government Finance Profession	government/organisations/civil-service-government-finance-profession	Sub-organisation		
civil-service-government-it-profession	Government IT Profession	government/organisations/civil-service-government-it-profession	Sub-organisation		
civil-service-government-knowledge-information-management-profession	Government Knowledge & Information Management Profession	government/organisations/civil-service-government-knowledge-information-management-profession	Sub-organisation		
civil-service-government-legal-service	Government Legal Service	government/organisations/civil-service-government-legal-service	Sub-organisation		
civil-service-government-occupational-psychology-profession	Government Occupational Psychology Profession	government/organisations/civil-service-government-occupational-psychology-profession	Sub-organisation		
civil-service-government-operational-research-service	Government Operational Research Service	government/organisations/civil-service-government-operational-research-service	Sub-organisation		
civil-service-government-planning-inspectors	Government Planning Inspectors	government/organisations/civil-service-government-planning-inspectors	Sub-organisation		
civil-service-government-property-profession	Government Property Profession	government/organisations/civil-service-government-property-profession	Sub-organisation		
civil-service-government-science-engineering	Government Science & Engineering Profession	government/organisations/civil-service-government-science-engineering	Sub-organisation		
civil-service-government-social-research-profession	Government Social Research Profession	government/organisations/civil-service-government-social-research-profession	Sub-organisation		
civil-service-government-statistical-service	Government Statistical Service	government/organisations/civil-service-government-statistical-service	Sub-organisation		
civil-service-government-tax-profession	Government Tax Profession	government/organisations/civil-service-government-tax-profession	Sub-organisation		
civil-service-government-veterinary-surgeons	Government Veterinary Services	government/organisations/civil-service-government-veterinary-surgeons	Sub-organisation		
civil-service-human-resources-profession	Human Resources Profession	government/organisations/civil-service-human-resources-profession	Sub-organisation		
civil-service-intelligence-analysis-profession	Intelligence Analysis	government/organisations/civil-service-intelligence-analysis-profession	Sub-organisation		
civil-service-internal-audit-profession	Internal Audit Profession	government/organisations/civil-service-internal-audit-profession	Sub-organisation		
civil-service-medical-profession	Medical Profession	government/organisations/civil-service-medical-profession	Sub-organisation		
civil-service-operational-delivery-profession	Operational Delivery Profession	government/organisations/civil-service-operational-delivery-profession	Sub-organisation		
civil-service-policy-profession	Policy Profession	government/organisations/civil-service-policy-profession	Sub-organisation		
civil-service-procurement-profession	Procurement profession	government/organisations/civil-service-procurement-profession	Sub-organisation		
civil-service-project-delivery-profession	Project Delivery Profession	government/organisations/civil-service-project-delivery-profession	Sub-organisation		
civil-service-reform	Civil Service Reform	government/organisations/civil-service-reform	Sub-organisation		
civil-service-resourcing	Civil Service Resourcing	government/organisations/civil-service-resourcing	Sub-organisation		
civil-service-the-government-planning-profession	Government Planning Profession	government/organisations/civil-service-the-government-planning-profession	Sub-organisation		
clacton-and-harwich-education-action-zone	Clacton and Harwich Education Action Zone	government/organisations/clacton-and-harwich-education-action-zone	Other		
co2sense	CO2Sense	government/organisations/co2sense	Other		2012-03
commercial-court	Commercial Court	courts-tribunals/commercial-court	Court		
commission-for-architecture-and-the-built-environment-cabe	Commission for Architecture and the Built Environment (CABE)	government/organisations/commission-for-architecture-and-the-built-environment-cabe	Advisory non-departmental public body		
commission-for-health-improvement	Commission for Health Improvement	government/organisations/commission-for-health-improvement	Other		31/03/2004
commission-for-patient-and-public-involvement-in-health	Commission for Patient and Public Involvement in Health	government/organisations/commission-for-patient-and-public-involvement-in-health	Other		31/03/2008
commission-for-racial-equality	Commission for Racial Equality	government/organisations/commission-for-racial-equality	Other		01/10/2007
commission-for-rural-communities	Commission for Rural Communities	government/organisations/commission-for-rural-communities	Other		2013-03
commission-for-social-care-inspection	Commission for Social Care Inspection	government/organisations/commission-for-social-care-inspection	Other		
commission-for-the-compact	Commission for the Compact	government/organisations/commission-for-the-compact	Other		31/03/2011
commission-on-human-medicines	Commission on Human Medicines	government/organisations/commission-on-human-medicines	Advisory non-departmental public body		
commissioner-for-public-appointments	Commissioner for Public Appointments	government/organisations/commissioner-for-public-appointments	Other		
committee-on-climate-change	Committee on Climate Change	government/organisations/committee-on-climate-change	Executive non-departmental public body		
committee-on-fuel-poverty	Committee on Fuel Poverty	government/organisations/committee-on-fuel-poverty	Advisory non-departmental public body		
committee-on-mutagenicity-of-chemicals-in-food-consumer-products-and-the-environment	"Committee on Mutagenicity of Chemicals in Food, Consumer Products and the Environment"	government/organisations/committee-on-mutagenicity-of-chemicals-in-food-consumer-products-and-the-environment	Advisory non-departmental public body		
committee-on-radioactive-waste-management	Committee on Radioactive Waste Management	government/organisations/committee-on-radioactive-waste-management	Advisory non-departmental public body		
committee-on-toxicity-of-chemicals-in-food-consumer-products-and-the-environment	"Committee on Toxicity of Chemicals in Food, Consumer Products and the Environment"	government/organisations/committee-on-toxicity-of-chemicals-in-food-consumer-products-and-the-environment	Advisory non-departmental public body		
commonwealth-scholarship-commission-in-the-uk	Commonwealth Scholarship Commission in the UK	government/organisations/commonwealth-scholarship-commission-in-the-uk	Executive non-departmental public body		
community-development-foundation	Community Development Foundation	government/organisations/community-development-foundation	Other		
community-fund	Community Fund	government/organisations/community-fund	Other		30/11/2006
companies-court	Companies Court	courts-tribunals/companies-court	Court		
companies-house	Companies House	government/organisations/companies-house	Executive agency		
company-names-tribunal	Company Names Tribunal	government/organisations/company-names-tribunal	Other		
compensation-agency	Compensation Agency	government/organisations/compensation-agency	Executive agency		
competition-and-markets-authority	Competition and Markets Authority	government/organisations/competition-and-markets-authority	Non-ministerial department		
competition-appeal-tribunal	Competition Appeal Tribunal	government/organisations/competition-appeal-tribunal	Tribunal non-departmental public body		
competition-commission	Competition Commission	government/organisations/competition-commission	Executive non-departmental public body		01/04/2014
competition-service	Competition Service	government/organisations/competition-service	Executive non-departmental public body		
construction-industry-training-board	Construction Industry Training Board	government/organisations/construction-industry-training-board	Executive non-departmental public body		
consumer-council-for-postal-services	Consumer Council for Postal Services	government/organisations/consumer-council-for-postal-services	Other		
consumer-council-for-water	Consumer Council for Water	government/organisations/consumer-council-for-water	Executive non-departmental public body		
consumer-focus	Consumer Futures	government/organisations/consumer-focus	Executive non-departmental public body		01/04/2014
cooksey-review	Cooksey Review	government/organisations/cooksey-review	Other		
copyright-tribunal	Copyright Tribunal	government/organisations/copyright-tribunal	Tribunal non-departmental public body		
corby-education-action-zone	Corby Education Action Zone	government/organisations/corby-education-action-zone	Other		
council-for-catholic-maintained-schools	Council for Catholic Maintained Schools	government/organisations/council-for-catholic-maintained-schools	Other		
council-for-healthcare-regulatory-excellence	Council for Healthcare Regulatory Excellence	government/organisations/council-for-healthcare-regulatory-excellence	Other		2012
council-for-science-and-technology	Council for Science and Technology	government/organisations/council-for-science-and-technology	Advisory non-departmental public body		
council-for-the-central-laboratory-of-the-research-councils	Council for the Central Laboratory of the Research Councils	government/organisations/council-for-the-central-laboratory-of-the-research-councils	Other		01/04/2007
council-on-tribunals	Council on Tribunals	government/organisations/council-on-tribunals	Tribunal non-departmental public body		
counter-fraud-and-security-management-service	Counter Fraud and Security Management Service	government/organisations/counter-fraud-and-security-management-service	Sub-organisation		
countryside-agency	Countryside Agency	government/organisations/countryside-agency	Executive agency		02/10/2006
court-of-appeal-civil-division	Court of Appeal Civil Division	courts-tribunals/court-of-appeal-civil-division	Court		
court-of-appeal-criminal-division	Court of Appeal Criminal Division	courts-tribunals/court-of-appeal-criminal-division	Court		
court-of-judicature-of-northern-ireland	Court of Judicature of Northern Ireland	government/organisations/court-of-judicature-of-northern-Ireland	Other		
court-of-protection	Court of Protection	courts-tribunals/court-of-protection	Court		
covent-garden-market-authority	Covent Garden Market Authority	government/organisations/covent-garden-market-authority	Other		
coventry-education-action-zone	Coventry Education Action Zone	government/organisations/coventry-education-action-zone	Other		
creative-scotland	Creative Scotland	government/organisations/creative-Scotland	Other		
criminal-cases-review-commission	Criminal Cases Review Commission	government/organisations/criminal-cases-review-commission	Executive non-departmental public body		
criminal-injuries-compensation-appeals-panel	Criminal Injuries Compensation Appeals Panel	government/organisations/criminal-injuries-compensation-appeals-panel	Other		
criminal-injuries-compensation-appeals-panel-for-northern-ireland	Criminal Injuries Compensation Appeals Panel for Northern Ireland	government/organisations/criminal-injuries-compensation-appeals-panel-for-northern-Ireland	Executive agency		
criminal-injuries-compensation-authority	Criminal Injuries Compensation Authority	government/organisations/criminal-injuries-compensation-authority	Executive agency		
criminal-justice-inspection-northern-ireland	Criminal Justice Inspection Northern Ireland	government/organisations/criminal-justice-inspection-northern-Ireland	Other		closed
criminal-procedure-rule-committee	Criminal Procedure Rule Committee	government/organisations/criminal-procedure-rule-committee	Advisory non-departmental public body		
criminal-records-bureau	Criminal Records Bureau	government/organisations/criminal-records-bureau	Other		01/12/2012
crown-agents-holding-and-realisation-board	Crown Agents Holding and Realisation Board	government/organisations/crown-agents-holding-and-realisation-board	Other		31/03/2008
crown-commercial-service	Crown Commercial Service	government/organisations/crown-commercial-service	Executive agency		
crown-prosecution-service	Crown Prosecution Service	government/organisations/crown-prosecution-service	Non-ministerial department		
dartmoor-national-park-authority	Dartmoor National Park Authority	government/organisations/dartmoor-national-park-authority	Other		
deepcut-review	Deepcut Review	government/organisations/deepcut-review	Other		
defence-academy	Defence Academy of the United Kingdom	government/organisations/defence-academy	Other		
defence-analytical-services-agency	Defence Analytical Services Agency	government/organisations/defence-analytical-services-agency	Executive agency		01/04/2008
defence-and-security-accelerator	Defence and Security Accelerator	government/organisations/defence-and-security-accelerator	Sub-organisation		
defence-and-security-media-advisory-committee	Defence and Security Media Advisory Committee	government/organisations/defence-and-security-media-advisory-committee	Other		
defence-aviation-repair-agency	Defence Aviation Repair Agency	government/organisations/defence-aviation-repair-agency	Executive agency		01/04/2008
defence-bills-agency	Defence Bills Agency	government/organisations/defence-bills-agency	Executive agency		01/04/2007
defence-communication-services-agency	Defence Communication Services Agency	government/organisations/defence-communication-services-agency	Executive agency		
defence-electronics-and-components-agency	Defence Electronics and Components Agency	government/organisations/defence-electronics-and-components-agency	Executive agency		
defence-equipment-and-support	Defence Equipment and Support	government/organisations/defence-equipment-and-support	Sub-organisation		
defence-estates	Defence Estates	government/organisations/defence-estates	Other		01/04/2011
defence-infrastructure-organisation	Defence Infrastructure Organisation	government/organisations/defence-infrastructure-organisation	Sub-organisation		
defence-intelligence-and-security-centre	Defence Intelligence and Security Centre	government/organisations/defence-intelligence-and-security-centre	Other		
defence-medical-education-and-training-agency	Defence Medical Education and Training Agency	government/organisations/defence-medical-education-and-training-agency	Executive agency		01/04/2008
defence-nuclear-safety-committee	Defence Nuclear Safety Committee	government/organisations/defence-nuclear-safety-committee	Advisory non-departmental public body		
defence-press-and-broadcasting-advisory-committee	"Defence, Press and Broadcasting Advisory Committee"	government/organisations/defence-press-and-broadcasting-advisory-committee	Other		
defence-procurement-agency	Defence Procurement Agency	government/organisations/defence-procurement-agency	Executive agency		01/04/2007
defence-safety-authority	Defence Safety Authority	government/organisations/defence-safety-authority	Sub-organisation		
defence-science-and-technology-laboratory	Defence Science and Technology Laboratory	government/organisations/defence-science-and-technology-laboratory	Executive agency		
defence-scientific-advisory-council	Defence Scientific Advisory Council	government/organisations/defence-scientific-advisory-council	Advisory non-departmental public body		
defence-sixth-form-college	Defence Sixth Form College	government/organisations/defence-sixth-form-college	Other		
defence-storage-and-distribution-agency	Defence Storage and Distribution Agency	government/organisations/defence-storage-and-distribution-agency	Executive agency		01/04/2009
defence-support-group	Defence Support Group	government/organisations/defence-support-group	Executive agency		31/03/2015
defence-transport-and-movements-agency	Defence Transport and Movements Agency	government/organisations/defence-transport-and-movements-agency	Executive agency		01/04/2007
defence-vetting-agency	Defence Vetting Agency	government/organisations/defence-vetting-agency	Executive agency		01/04/2012
dental-practice-board	Dental Practice Board	government/organisations/dental-practice-board	Other		31/03/2006
dental-vocational-training-authority	Dental Vocational Training Authority	government/organisations/dental-vocational-training-authority	Other		31/03/2006
department-for-business-energy-and-industrial-strategy	"Department for Business, Energy & Industrial Strategy"	government/organisations/department-for-business-energy-and-industrial-strategy	Ministerial department		
department-for-business-enterprise-and-regulatory-reform	"Department for Business, Enterprise and Regulatory Reform"	government/organisations/department-for-business-enterprise-and-regulatory-reform	Ministerial department		
department-for-business-innovation-skills	"Department for Business, Innovation & Skills"	government/organisations/department-for-business-innovation-skills	Ministerial department		14/07/2016
department-for-children-schools-and-families	"Department for Children, Schools and Families"	government/organisations/department-for-children-schools-and-families	Ministerial department		
department-for-communities-and-local-government	Department for Communities and Local Government	government/organisations/department-for-communities-and-local-government	Ministerial department		
department-for-communities-northern-ireland	Department for Communities (Northern Ireland)	government/organisations/department-for-communities-northern-Ireland	Other		
department-for-constitutional-affairs	Department for Constitutional Affairs	government/organisations/department-for-constitutional-affairs	Ministerial department		
department-for-culture-media-sport	"Department for Culture, Media & Sport"	government/organisations/department-for-culture-media-sport	Ministerial department		
department-for-education	Department for Education	government/organisations/department-for-education	Ministerial department		
department-for-education-and-skills	Department for Education and Skills	government/organisations/department-for-education-and-skills	Ministerial department		2007
department-for-employment-and-learning	Department for Employment and Learning	government/organisations/department-for-employment-and-learning	Ministerial department		
department-for-environment-food-rural-affairs	"Department for Environment, Food & Rural Affairs"	government/organisations/department-for-environment-food-rural-affairs	Ministerial department		
department-for-exiting-the-european-union	Department for Exiting the European Union	government/organisations/department-for-exiting-the-european-union	Ministerial department		
department-for-infrastructure-northern-ireland	Department for Infrastructure (Northern Ireland)	government/organisations/department-for-infrastructure-northern-Ireland	Other		
department-for-innovation-universities-and-skills	"Department for Innovation, Universities and Skills"	government/organisations/department-for-innovation-universities-and-skills	Ministerial department		2009-06
department-for-international-development	Department for International Development	government/organisations/department-for-international-development	Ministerial department		
department-for-international-trade	Department for International Trade	government/organisations/department-for-international-trade	Ministerial department		
department-for-regional-development	Department for Regional Development	government/organisations/department-for-regional-development	Ministerial department		
department-for-social-development	Department for Social Development	government/organisations/department-for-social-development	Ministerial department		
department-for-the-economy-northern-ireland	Department for the Economy (Northern Ireland)	government/organisations/department-for-the-economy-northern-ireland	Other		
department-for-transport	Department for Transport	government/organisations/department-for-transport	Ministerial department		
department-for-work-pensions	Department for Work and Pensions	government/organisations/department-for-work-pensions	Ministerial department		
department-of-agriculture-and-rural-development	Department of Agriculture and Rural Development	government/organisations/department-of-agriculture-and-rural-development	Ministerial department		
department-of-agriculture-environment-and-rural-affairs-northern-ireland	"Department of Agriculture, Environment and Rural Affairs (Northern Ireland)"	government/organisations/department-of-agriculture-environment-and-rural-affairs-northern-ireland	Other		
department-of-constitutional-affairs	Department of Constitutional Affairs	government/organisations/department-of-constitutional-affairs	Ministerial department		09/05/2007
department-of-culture-arts-and-leisure	"Department of Culture, Arts and Leisure"	government/organisations/department-of-culture-arts-and-leisure	Ministerial department		
department-of-culture-arts-and-leisure-northern-ireland	"Department of Culture, Arts and Leisure Northern Ireland"	government/organisations/department-of-culture-arts-and-leisure-northern-Ireland	Executive agency		
department-of-education	Department of Education (Northern Ireland)	government/organisations/department-of-education	Other		
department-of-energy-climate-change	Department of Energy & Climate Change	government/organisations/department-of-energy-climate-change	Ministerial department		14/07/2016
department-of-enterprise-trade-and-investment	"Department of Enterprise, Trade and Investment"	government/organisations/department-of-enterprise-trade-and-investment	Ministerial department		
department-of-finance-and-personnel-for-northern-ireland	Department of Finance and Personnel for Northern Ireland	government/organisations/department-of-finance-and-personnel-for-northern-ireland	Ministerial department		
department-of-finance-northern-ireland	Department of Finance (Northern Ireland)	government/organisations/department-of-finance-northern-Ireland	Other		
department-of-health	Department of Health	government/organisations/department-of-health	Ministerial department		
department-of-health-northern-ireland	Department of Health (Northern Ireland)	government/organisations/department-of-health-northern-Ireland	Other		
department-of-health-social-services-and-public-safety	"Department of Health, Social Services and Public Safety"	government/organisations/department-of-health-social-services-and-public-safety	Ministerial department		
department-of-inland-revenue	Department of Inland Revenue	government/organisations/department-of-inland-revenue	Ministerial department		2005-il-Ap
department-of-justice-northern-ireland	Department of Justice (Northern Ireland)	government/organisations/department-of-justice-northern-Ireland	Other		
department-of-national-heritage	Department of National Heritage	government/organisations/department-of-national-heritage	Other		1997
department-of-social-security	Department of Social Security	government/organisations/department-of-social-security	Ministerial department		2001
department-of-the-environment	Department of the Environment (Northern Ireland)	government/organisations/department-of-the-environment	Ministerial department		
department-of-the-environment-transport-and-the-regions	"Department of the Environment, Transport and the Regions"	government/organisations/department-of-the-environment-transport-and-the-regions	Other		2001
department-of-trade-and-industry	Department of Trade and Industry	government/organisations/department-of-trade-and-industry	Ministerial department		
deputy-prime-ministers-office	Deputy Prime Minister's Office	government/organisations/deputy-prime-ministers-office	Executive office		08/05/2015
derby-north-east-education-action-zone	Derby North East Education Action Zone	government/organisations/derby-north-east-education-action-zone	Other		16/04/2005
design-council	Design Council	government/organisations/design-council	Other		closed
digital-data-and-technology-professions	"Digital, data and technology professions"	government/organisations/digital-data-and-technology-professions	Sub-organisation		
dingle-granby-toxteth-education-action-zone	Dingle Granby Toxteth Education Action Zone	government/organisations/dingle-granby-toxteth-education-action-zone	Other		09/01/2005
directly-operated-railways-limited	Directly Operated Railways Limited	government/organisations/directly-operated-railways-limited	Executive non-departmental public body		
disability-and-carers-service	Disability and Carers Service	government/organisations/disability-and-carers-service	Executive agency		2008
disability-rights-commission	Disability Rights Commission	government/organisations/disability-rights-commission	Other		01/10/2007
disabled-peoples-employment-corporation	Disabled PeopleÕs Employment Corporation	government/organisations/disabled-peoples-employment-corporation	Executive non-departmental public body		
disabled-persons-transport-advisory-committee	Disabled Persons Transport Advisory Committee	government/organisations/disabled-persons-transport-advisory-committee	Advisory non-departmental public body		
disclosure-and-barring-service	Disclosure and Barring Service	government/organisations/disclosure-and-barring-service	Executive non-departmental public body		
disposal-services-agency	Disposal Services Agency	government/organisations/disposal-services-agency	Executive agency		01/04/2007
district-valuer-services-dvs	District Valuer Services (DVS)	government/organisations/district-valuer-services-dvs	Sub-organisation		
dormant-assets-commission	Independent Dormant Assets Commission	government/organisations/dormant-assets-commission	Advisory non-departmental public body		
downham-and-bellingham-education-action-zone	Downham and Bellingham Education Action Zone	government/organisations/downham-and-bellingham-education-action-zone	Other		09/01/2005
drinking-water-inspectorate	Drinking Water Inspectorate	government/organisations/drinking-water-inspectorate	Other		
driver-and-vehicle-licensing-agency	Driver and Vehicle Licensing Agency	government/organisations/driver-and-vehicle-licensing-agency	Executive agency		
driver-and-vehicle-standards-agency	Driver and Vehicle Standards Agency	government/organisations/driver-and-vehicle-standards-agency	Executive agency		
driver-and-vehicle-testing-agency	Driver and Vehicle Testing Agency	government/organisations/driver-and-vehicle-testing-agency	Executive agency		2007
driving-standards-agency	Driving Standards Agency	government/organisations/driving-standards-agency	Executive agency		01/04/2014
dudley-education-action-zone	Dudley Education Action Zone	government/organisations/dudley-education-action-zone	Other		30/11/2004
easington-and-seaham-education-action-zone	Easington and Seaham Education Action Zone	government/organisations/easington-and-seaham-education-action-zone	Other		09/01/2005
east-cleveland-education-action-zone	East Cleveland Education Action Zone	government/organisations/east-cleveland-education-action-zone	Other		09/01/2005
east-manchester-education-action-zone	East Manchester Education Action Zone	government/organisations/east-manchester-education-action-zone	Other		30/11/2004
east-midlands-development-agency-emda	East Midlands Development Agency (emda)	government/organisations/east-midlands-development-agency-emda	Executive agency		30/03/2012
east-of-england-development-agency	East of England Development Agency	government/organisations/east-of-england-development-agency	Executive agency		01/07/2012
eastern-health-and-social-services-board	Eastern Health and Social Services Board	government/organisations/eastern-health-and-social-services-board	Other		closed
ebbsfleet-development-corporation	Ebbsfleet Development Corporation	government/organisations/ebbsfleet-development-corporation	Executive non-departmental public body		
economic-and-social-research-council	Economic and Social Research Council	government/organisations/economic-and-social-research-council	Executive non-departmental public body		
education-funding-agency	Education Funding Agency	government/organisations/education-funding-agency	Executive agency		
efficiency-and-reform-group	Efficiency and Reform Group	government/organisations/efficiency-and-reform-group	Sub-organisation		
eliasch-review	Eliasch Review	government/organisations/eliasch-review	Other		closed
ellesmere-port-education-action-zone	Ellesmere Port Education Action Zone	government/organisations/ellesmere-port-education-action-zone	Other		09/01/2005
employment-appeal-tribunal	Employment Appeal Tribunal	courts-tribunals/employment-appeal-tribunal	Tribunal non-departmental public body		
employment-tribunal	Employment Tribunal	employment-tribunals	Tribunal non-departmental public body		
engineering-and-physical-sciences-research-council	Engineering and Physical Sciences Research Council	government/organisations/engineering-and-physical-sciences-research-council	Executive non-departmental public body		
engineering-construction-industry-training-board	Engineering Construction Industry Training Board	government/organisations/engineering-construction-industry-training-board	Executive non-departmental public body		
english-heritage	English Heritage	government/organisations/english-heritage	Executive non-departmental public body		01/04/2015
english-institute-of-sport	English Institute of Sport	government/organisations/english-institute-of-sport	Other		
english-nature	English Nature	government/organisations/english-nature	Executive agency		01/10/2006
english-partnerships	English Partnerships	government/organisations/english-partnerships	Executive agency		01/12/2008
english-sports-council	English Sports Council	government/organisations/english-sports-council	Other		1997
enterprise-ulster	Enterprise Ulster	government/organisations/enterprise-ulster	Other		21/03/2006
environment-agency	Environment Agency	government/organisations/environment-agency	Executive non-departmental public body		
environment-and-heritage-service	Environment and Heritage Service	government/organisations/environment-and-heritage-service	Executive agency		
equal-opportunities-commission	Equal Opportunities Commission	government/organisations/equal-opportunities-commission	Other		30/09/2007
equality-2025	Equality 2025	government/organisations/equality-2025	Advisory non-departmental public body		2013-09
equality-and-human-rights-commission	Equality and Human Rights Commission	government/organisations/equality-and-human-rights-commission	Executive non-departmental public body		
equality-commission-for-northern-ireland	Equality Commission for Northern Ireland	government/organisations/equality-commission-for-northern-Ireland	Other		
equitable-life-inquiry	Equitable Life Inquiry	government/organisations/equitable-life-inquiry	Other		2000-12
estyn	Estyn	government/organisations/estyn	Other		
examination-team-on-child-care-procedures-and-practice-in-north-wales	Examination team on child care procedures and practice in North Wales	government/organisations/examination-team-on-child-care-procedures-and-practice-in-north-wales	Other		17/06/1996
exchequer-and-audit-department	Exchequer and Audit Department	government/organisations/exchequer-and-audit-department	Ministerial department		1983
exmoor-national-park-authority	Exmoor National Park Authority	government/organisations/exmoor-national-park-authority	Other		
export-control-organisation	Export Control Organisation	government/organisations/export-control-organisation	Sub-organisation		
export-guarantees-advisory-council	Export Guarantees Advisory Council	government/organisations/export-guarantees-advisory-council	Advisory non-departmental public body		
family-division-of-the-high-court	Family Division of the High Court	courts-tribunals/family-division-of-the-high-court	Court		
family-health-services-appeal-authority	Family Health Services Appeal Authority	government/organisations/family-health-services-appeal-authority	Other		31/03/2015
family-justice-council	Family Justice Council	government/organisations/family-justice-council	Advisory non-departmental public body		
family-procedure-rule-committee	Family Procedure Rule Committee	government/organisations/family-procedure-rule-committee	Advisory non-departmental public body		
fco-services	FCO Services	government/organisations/fco-services	Executive agency		
financial-conduct-authority	Financial Conduct Authority	government/organisations/financial-conduct-authority	Other		
financial-services-organisation	Financial Services Organisation	government/organisations/financial-services-organisation	Sub-organisation		
financial-services-trade-and-investment-board	Financial Services Trade and Investment Board	government/organisations/financial-services-trade-and-investment-board	Sub-organisation		
fire-authority-for-northern-ireland	Fire Authority for Northern Ireland	government/organisations/fire-authority-for-northern-Ireland	Other		
fire-service-college	Fire Service College	government/organisations/fire-service-college	Other		
firearms-consultative-committee	Firearms Consultative Committee	government/organisations/firearms-consultative-committee	Other		31/01/2004
firebuy	Firebuy	government/organisations/firebuy	Other		13/07/2011
first-tier-tribunal-asylum-support	First-tier Tribunal (Asylum Support)	government/organisations/first-tier-tribunal-asylum-support	Tribunal non-departmental public body		
first-tier-tribunal-care-standards	First-tier Tribunal (Care Standards)	government/organisations/first-tier-tribunal-care-standards	Tribunal non-departmental public body		
first-tier-tribunal-criminal-injuries-compensation	First-tier Tribunal (Criminal Injuries Compensation)	government/organisations/first-tier-tribunal-criminal-injuries-compensation	Tribunal non-departmental public body		
first-tier-tribunal-general-regulatory-chamber	First-tier Tribunal (General Regulatory Chamber)	government/organisations/first-tier-tribunal-general-regulatory-chamber	Tribunal non-departmental public body		
first-tier-tribunal-immigration-and-asylum	First-tier Tribunal (Immigration and Asylum)	government/organisations/first-tier-tribunal-immigration-and-asylum	Tribunal non-departmental public body		
first-tier-tribunal-mental-health	First-tier Tribunal (Mental Health)	government/organisations/first-tier-tribunal-mental-health	Tribunal non-departmental public body		
first-tier-tribunal-property-chamber	First-tier Tribunal (Property Chamber)	government/organisations/first-tier-tribunal-property-chamber	Tribunal non-departmental public body		
first-tier-tribunal-social-security-and-child-support	First-tier Tribunal (Social Security and Child Support)	government/organisations/first-tier-tribunal-social-security-and-child-support	Tribunal non-departmental public body		
first-tier-tribunal-special-educational-needs-and-disability	First-tier Tribunal (Special Educational Needs and Disability)	government/organisations/first-tier-tribunal-special-educational-needs-and-disability	Tribunal non-departmental public body		
first-tier-tribunal-tax	First-tier Tribunal (Tax)	government/organisations/first-tier-tribunal-tax	Tribunal non-departmental public body		
first-tier-tribunal-war-pensions-and-armed-forces-compensation	First-tier Tribunal (War Pensions and Armed Forces Compensation)	government/organisations/first-tier-tribunal-war-pensions-and-armed-forces-compensation	Tribunal non-departmental public body		
fisheries-conservancy-board-for-northern-ireland	Fisheries Conservancy Board for Northern Ireland	government/organisations/fisheries-conservancy-board-for-northern-Ireland	Other		
fleet-air-arm-museum	Fleet Air Arm Museum	government/organisations/fleet-air-arm-museum	Other		
food-from-britain	Food from Britain	government/organisations/food-from-britain	Other		31/03/2009
food-safety-promotion-board	Food Safety Promotion Board	government/organisations/food-safety-promotion-board	Other		
food-standards-agency	Food Standards Agency	government/organisations/food-standards-agency	Non-ministerial department		
football-licensing-authority	Football Licensing Authority	government/organisations/football-licensing-authority	Other		14/10/2010
foreign-commonwealth-office	Foreign & Commonwealth Office	government/organisations/foreign-commonwealth-office	Ministerial department		
foreign-compensation-commission	Foreign Compensation Commission	government/organisations/foreign-compensation-commission	Tribunal non-departmental public body		
forensic-science-northern-ireland	Forensic Science Northern Ireland	government/organisations/forensic-science-northern-Ireland	Executive agency		
forensic-science-regulator	Forensic Science Regulator	government/organisations/forensic-science-regulator	Other		
forensic-science-service	Forensic Science Service	government/organisations/forensic-science-service	Other		04/12/2005
forest-enterprise-england	Forest Enterprise (England)	government/organisations/forest-enterprise-england	Executive agency		
forest-research	Forest Research	government/organisations/forest-research	Executive agency		
forest-service	Forest Service	government/organisations/forest-service	Other		
forestry-commission	Forestry Commission	government/organisations/forestry-commission	Non-ministerial department		
further-and-higher-education-funding-councils-for-wales	Further and Higher Education Funding Councils for Wales	government/organisations/further-and-higher-education-funding-councils-for-wales	Other		
gambling-commission	Gambling Commission	government/organisations/gambling-commission	Executive non-departmental public body		
gaming-board-for-great-britain	Gaming Board for Great Britain	government/organisations/gaming-board-for-great-britain	Other		01/09/2007
gangmasters-licensing-appeals	Gangmasters Licensing Appeals	courts-tribunals/gangmasters-licensing-appeals	Tribunal non-departmental public body		
gangmasters-licensing-authority	Gangmasters Licensing Authority	government/organisations/gangmasters-licensing-authority	Executive non-departmental public body		
gas-and-electricity-consumer-council-energywatch	Gas and Electricity Consumer Council (Energywatch)	government/organisations/gas-and-electricity-consumer-council-energywatch	Other		2008
geffrye-museum	Geffrye Museum	government/organisations/geffrye-museum	Executive non-departmental public body		
general-advisory-committee-on-science	General Advisory Committee on Science	government/organisations/general-advisory-committee-on-science	Advisory non-departmental public body		
general-consumer-council-for-northern-ireland	General Consumer Council for Northern Ireland	government/organisations/general-consumer-council-for-northern-Ireland	Other		
general-social-care-council	General Social Care Council	government/organisations/general-social-care-council	Other		30/09/2012
general-teaching-council-for-england	General Teaching Council for England	government/organisations/general-teaching-council-for-england	Executive agency		31/03/2012
gloucester-education-action-zone	Gloucester Education Action Zone	government/organisations/gloucester-education-action-zone	Other		09/01/2005
government-actuarys-department	Government Actuary's Department	government/organisations/government-actuarys-department	Non-ministerial department		
government-car-and-despatch-agency	Government Car and Despatch Agency	government/organisations/government-car-and-despatch-agency	Executive agency		30/12/2009
government-chemist	Government Chemist	government/organisations/government-chemist	Sub-organisation		
government-commercial-function	Government Commercial Function	government/organisations/government-commercial-function	Sub-organisation		
government-communications-headquarters	Government Communications Headquarters	government/organisations/government-communications-headquarters	Other		
government-digital-service	Government Digital Service	government/organisations/government-digital-service	Sub-organisation		
government-equalities-office	Government Equalities Office	government/organisations/government-equalities-office	Other		
government-estates-management	Government Estates Management	government/organisations/government-estates-management	Other		
government-internal-audit-agency	Government Internal Audit Agency	government/organisations/government-internal-audit-agency	Executive agency		
government-legal-department	Government Legal Department	government/organisations/government-legal-department	Non-ministerial department		
government-office-for-science	Government Office for Science	government/organisations/government-office-for-science	Other		
government-procurement-service	Government Procurement Service	government/organisations/government-procurement-service	Executive agency		01/04/2014
government-security-profession	Government Security Profession	government/organisations/government-security-profession	Sub-organisation		
gowers-review-of-intellectual-property	Gowers Review of Intellectual Property	government/organisations/gowers-review-of-intellectual-property	Other		2006-12
great-britain-china-centre	Great Britain-China Centre	government/organisations/great-britain-china-centre	Executive non-departmental public body		
great-yarmouth-education-action-zone	Great Yarmouth Education Action Zone	government/organisations/great-yarmouth-education-action-zone	Other		16/04/2005
greenwich-education-action-zone	Greenwich Education Action Zone	government/organisations/greenwich-education-action-zone	Other		05/09/2004
groceries-code-adjudicator	Groceries Code Adjudicator	government/organisations/groceries-code-adjudicator	Other		
hackney-education-action-zone	Hackney Education Action Zone	government/organisations/hackney-education-action-zone	Other		30/11/2004
hamilton-oxford-education-action-zone	Hamilton Oxford Education Action Zone	government/organisations/hamilton-oxford-education-action-zone	Other		06/09/2004
hastings-and-st-leonards-education-action-zone	Hastings and St Leonards Education Action Zone	government/organisations/hastings-and-st-leonards-education-action-zone	Other		30/11/2004
health-and-safety-executive	Health and Safety Executive	government/organisations/health-and-safety-executive	Executive non-departmental public body		
health-and-social-care-information-centre	Health and Social Care Information Centre	government/organisations/health-and-social-care-information-centre	Executive non-departmental public body		
health-education-england	Health Education England	government/organisations/health-education-england	Executive non-departmental public body		
health-protection-agency	Health Protection Agency	government/organisations/health-protection-agency	Executive agency		01/04/2013
health-research-authority	Health Research Authority	government/organisations/health-research-authority	Executive non-departmental public body		
healthcare-commission	Healthcare Commission	government/organisations/healthcare-commission	Other		31/03/2009
healthcare-uk	Healthcare UK	government/organisations/healthcare-uk	Sub-organisation		
hearing-aid-council	Hearing Aid Council	government/organisations/hearing-aid-council	Other		31/07/2010
heart-of-slough-education-action-zone	Heart of Slough Education Action Zone	government/organisations/heart-of-slough-education-action-zone	Other		
her-majestys-magistrates-courts-service-inspectorate	Her Majesty's Magistrates Courts Service Inspectorate	government/organisations/her-majestys-magistrates-courts-servuce-inspectorate	Other		closed
heritage-lottery-fund	Heritage Lottery Fund (administered by the NHMF)	government/organisations/heritage-lottery-fund	Executive non-departmental public body		
high-speed-two-limited	High Speed Two (HS2) Limited	government/organisations/high-speed-two-limited	Executive non-departmental public body		
higher-education-funding-council-for-england	Higher Education Funding Council for England	government/organisations/higher-education-funding-council-for-england	Executive non-departmental public body		
higher-education-statistical-agency	Higher Education Statistics Agency	government/organisations/higher-education-statistical-agency	Other		closed
highways-agency	Highways Agency	government/organisations/highways-agency	Executive agency		01/04/2015
highways-england	Highways England	government/organisations/highways-england	Other		
hillsborough-independent-panel	Hillsborough Independent Panel	government/organisations/hillsborough-independent-panel	Other		12/09/2012
historic-england	Historic England	government/organisations/historic-england	Executive non-departmental public body		
historic-royal-palaces	Historic Royal Palaces	government/organisations/historic-royal-palaces	Public corporation		
hm-court-service	HM Courts Service	government/organisations/hm-court-service	Executive agency		
hm-courts-and-tribunals-service	HM Courts & Tribunals Service	government/organisations/hm-courts-and-tribunals-service	Executive agency		
hm-crown-prosecution-service-inspectorate	HM Crown Prosecution Service Inspectorate	government/organisations/hm-crown-prosecution-service-inspectorate	Other		
hm-customs-and-excise	H.M. Customs and Excise	government/organisations/hm-customs-and-excise	Other		2005-04
hm-inspectorate-of-constabulary	HM Inspectorate of Constabulary	government/organisations/hm-inspectorate-of-constabulary	Other		
hm-inspectorate-of-court-administration	H.M. Inspectorate of Court Administration	government/organisations/hm-inspectorate-of-court-administration	Other		2010-12
hm-inspectorate-of-explosives-for-northern-ireland	H.M. Inspectorate of Explosives for Northern Ireland	government/organisations/hm-inspectorate-of-explosives-for-northern-Ireland	Other		closed
hm-inspectorate-of-prisons	HM Inspectorate of Prisons	government/organisations/hm-inspectorate-of-prisons	Other		
hm-inspectorate-of-probation	HM Inspectorate of Probation	government/organisations/hm-inspectorate-of-probation	Other		
hm-nautical-almanac-office	HM Nautical Almanac Office	government/organisations/hm-nautical-almanac-office	Sub-organisation		
hm-passport-office	HM Passport Office	government/organisations/hm-passport-office	Sub-organisation		
hm-prison-service	HM Prison Service	government/organisations/hm-prison-service	Executive agency		
hm-revenue-customs	HM Revenue & Customs	government/organisations/hm-revenue-customs	Non-ministerial department		
hm-treasury	HM Treasury	government/organisations/hm-treasury	Ministerial department		
home-grown-cereals-authority	Home-Grown Cereals Authority	government/organisations/home-grown-cereals-authority	Other		31/03/2008
home-office	Home Office	government/organisations/home-office	Ministerial department		
homes-and-communities-agency	Homes and Communities Agency	government/organisations/homes-and-communities-agency	Executive non-departmental public body		
horniman-museum	Horniman Public Museum and Public Park Trust	government/organisations/horniman-museum	Executive non-departmental public body		
horserace-betting-levy-board	Horserace Betting Levy Board	government/organisations/horserace-betting-levy-board	Executive non-departmental public body		
horticultural-development-council	Horticultural Development Council	government/organisations/horticultural-development-council	Other		01/04/2008
house-of-lords-appointments-commission	House of Lords Appointments Commission	government/organisations/house-of-lords-appointments-commission	Advisory non-departmental public body		
housing-corporation	Housing Corporation	government/organisations/housing-corporation	Executive agency		01/12/2008
housing-ombudsman	Housing Ombudsman	government/organisations/housing-ombudsman	Executive non-departmental public body		
human-fertilisation-and-embryology-authority	Human Fertilisation and Embryology Authority	government/organisations/human-fertilisation-and-embryology-authority	Executive non-departmental public body		
human-tissue-authority	Human Tissue Authority	government/organisations/human-tissue-authority	Executive non-departmental public body		
hybu-cig-cymru-meat-promotion-wales	Hybu Cig Cymru - Meat Promotion Wales	government/organisations/hybu-cig-cymru-meat-promotion-wales	Other		
icl-inquiry	ICL Inquiry	government/organisations/icl-inquiry	Other		closed
identity-and-passport-service	Identity and Passport Service	government/organisations/identity-and-passport-service	Other		closed
immigration-enforcement	Immigration Enforcement	government/organisations/immigration-enforcement	Sub-organisation		
imperial-war-museum	Imperial War Museum	government/organisations/imperial-war-museum	Executive non-departmental public body		
independent-advisory-panel-on-deaths-in-custody	Independent Advisory Panel on Deaths in Custody	government/organisations/independent-advisory-panel-on-deaths-in-custody	Advisory non-departmental public body		
independent-agricultural-appeals-panel	Independent Agricultural Appeals Panel	government/organisations/independent-agricultural-appeals-panel	Advisory non-departmental public body		
independent-anti-slavery-commissioner	Independent Anti-slavery Commissioner	government/organisations/independent-anti-slavery-commissioner	Independent monitoring body		
independent-case-examiner	Independent Case Examiner	government/organisations/independent-case-examiner	Other		
independent-commission-for-aid-impact	Independent Commission for Aid Impact	government/organisations/independent-commission-for-aid-impact	Advisory non-departmental public body		
independent-commission-on-freedom-of-information	Independent Commission on Freedom of Information	government/organisations/independent-commission-on-freedom-of-information	Advisory non-departmental public body		
independent-complaints-reviewer	Independent Complaints Reviewer	government/organisations/independent-complaints-reviewer	Other		
independent-family-returns-panel	Independent Family Returns Panel	government/organisations/independent-family-returns-panel	Other		
independent-living-fund	Independent Living Fund	government/organisations/independent-living-fund	Executive non-departmental public body		30/06/2015
independent-medical-expert-group	Independent Medical Expert Group	government/organisations/independent-medical-expert-group	Advisory non-departmental public body		
independent-monitoring-boards-of-prisons-immigration-removal-centres-and-short-term-holding-rooms	"Independent Monitoring Boards of Prisons, Immigration, Removal Centres and Short Term Holding Rooms"	government/organisations/independent-monitoring-boards-of-prisons-immigration-removal-centres-and-short-term-holding-rooms	Other		
independent-monitoring-commission	Independent Monitoring Commission	government/organisations/independent-monitoring-commission	Other		2011
independent-police-complaint-commission	Independent Police Complaints Commission	government/organisations/independent-police-complaint-commission	Executive non-departmental public body		
independent-reconfiguration-panel	Independent Reconfiguration Panel	government/organisations/independent-reconfiguration-panel	Advisory non-departmental public body		
independent-review-of-police-officer-and-staff-remuneration-and-conditions	Independent Review of Police Officer and Staff Remuneration and Conditions	government/organisations/independent-review-of-police-officer-and-staff-remuneration-and-conditions	Other		closed
independent-review-of-the-uk-postal-services-sector	Independent Review of the UK Postal Services Sector	government/organisations/independent-review-of-the-uk-postal-services-sector	Other		2008-12
independent-reviewer-of-terrorism-legislation	Independent Reviewer of Terrorism Legislation	government/organisations/independent-reviewer-of-terrorism-legislation	Other		
independent-safeguarding-authority	Independent Safeguarding Authority	government/organisations/independent-safeguarding-authority	Other		30/11/2014
independent-television-commission	Independent Television Commission	government/organisations/independent-television-commission	Other		28/12/2003
industrial-development-advisory-board	Industrial Development Advisory Board	government/organisations/industrial-development-advisory-board	Advisory non-departmental public body		
industrial-injuries-advisory-council	Industrial Injuries Advisory Council	government/organisations/industrial-injuries-advisory-council	Advisory non-departmental public body		
information-commissioner-s-office	Information Commissioner's Office	government/organisations/information-commissioner-s-office	Executive non-departmental public body		
information-services-division-scotland	Information Services Division (Scotland)	government/organisations/information-services-division-scotland	Other		
infrastructure-and-projects-authority	Infrastructure and Projects Authority	government/organisations/infrastructure-and-projects-authority	Sub-organisation		
infrastructure-planning-commission	Infrastructure Planning Commission	government/organisations/infrastructure-planning-commission	Other		31/01/2012
infrastructure-uk	Infrastructure UK	government/organisations/infrastructure-uk	Sub-organisation		01/01/2016
innovate-uk	Innovate UK	government/organisations/innovate-uk	Executive non-departmental public body		
inquiry-into-the-supervision-of-the-bank-of-credit-and-commerce-international	Inquiry into the supervision of the Bank of Credit and Commerce International	government/organisations/inquiry-into-the-supervision-of-the-bank-of-credit-and-commerce-international	Other		1992
insolvency-practitioners-tribunal	Insolvency Practitioners Tribunal	government/organisations/insolvency-practitioners-tribunal	Tribunal non-departmental public body		
insolvency-rules-committee	Insolvency Rules Committee	government/organisations/insolvency-rules-committee	Advisory non-departmental public body		
insolvency-service	The Insolvency Service	government/organisations/insolvency-service	Executive agency		
intellectual-property-enterprise-court	Intellectual Property Enterprise Court	courts-tribunals/intellectual-property-enterprise-court	Court		
intellectual-property-office	Intellectual Property Office	government/organisations/intellectual-property-office	Executive agency		
intelligence-services-commissioner	Intelligence Services Commissioner	government/organisations/intelligence-services-commissioner	Other		
interception-of-communications-commissioner	Interception of Communications Commissioner	government/organisations/interception-of-communications-commissioner	Other		
investigation-into-the-role-of-jimmy-savile-at-broadmoor-hospital	Broadmoor Hospital investigation	government/organisations/investigation-into-the-role-of-jimmy-savile-at-broadmoor-hospital	Sub-organisation		
investigatory-powers-tribunal	Investigatory Powers Tribunal	government/organisations/investigatory-powers-tribunal	Tribunal non-departmental public body		
investors-in-people-uk	Investors in People UK	government/organisations/investors-in-people-uk	Other		
iraq-inquiry	Iraq Inquiry	government/organisations/iraq-inquiry	Other		2009
jeffrey-review	The Jeffrey Review	government/organisations/jeffrey-review	Other		2014-05
joint-forces-command	Joint Forces Command	government/organisations/joint-forces-command	Sub-organisation		
joint-nature-conservation-committee	Joint Nature Conservation Committee	government/organisations/joint-nature-conservation-committee	Executive non-departmental public body		
judicial-appointments-and-conduct-ombudsman	Judicial Appointments and Conduct Ombudsman	government/organisations/judicial-appointments-and-conduct-ombudsman	Other		
judicial-appointments-commission	Judicial Appointments Commission	government/organisations/judicial-appointments-commission	Executive non-departmental public body		
kent-and-somerset-education-action-zone	Kent and Somerset Education Action Zone	government/organisations/kent-and-somerset-education-action-zone	Other		30/11/2004
kerr-haslam-inquiry	Kerr / Haslam Inquiry	government/organisations/kerr-haslam-inquiry	Other		18/07/2005
kitts-green-and-shard-end-education-action-zone	Kitts Green and Shard End Education Action Zone	government/organisations/kitts-green-and-shard-end-education-action-zone	Other		closed
labour-relations-agency	Labour Relations Agency	government/organisations/labour-relations-agency	Executive agency		
lake-district-national-park-authority	Lake District National Park Authority	government/organisations/lake-district-national-park-authority	Other		
lammy-review	Lammy Review	government/organisations/lammy-review	Other		
land-registers-of-northern-ireland	Land Registers of Northern Ireland	government/organisations/land-registers-of-northern-Ireland	Executive agency		
land-registration-rule-committee	Land Registration Rule Committee	government/organisations/land-registration-rule-committee	Advisory non-departmental public body		
land-registry	Land Registry	government/organisations/land-registry	Non-ministerial department		
law-commission	Law Commission	government/organisations/law-commission	Advisory non-departmental public body		
learning-and-skills-council	Learning and Skills Council	government/organisations/learning-and-skills-council	Executive agency		01/04/2010
leasehold-advisory-service	Leasehold Advisory Service	government/organisations/leasehold-advisory-service	Executive non-departmental public body		
legal-aid-agency	Legal Aid Agency	government/organisations/legal-aid-agency	Executive agency		
legal-aid-board	Legal Aid Board	government/organisations/legal-aid-board	Other		2000
legal-services-board	Legal Services Board	government/organisations/legal-services-board	Executive non-departmental public body		
legal-services-commission	Legal Services Commission	government/organisations/legal-services-commission	Executive agency		01/04/2013
leigh-park-education-action-zone	Leigh Park Education Action Zone	government/organisations/leigh-park-education-action-zone	Other		09/01/2005
leitch-review-of-skills	Leitch Review of Skills	government/organisations/leitch-review-of-skills	Other		2006-12
leveson-inquiry	Leveson Inquiry	government/organisations/leveson-inquiry	Other		2012
life-sentence-review-commissioners	Life Sentence Review Commissioners	government/organisations/life-sentence-review-commissioners	Other		
livestock-and-meat-commission-for-northern-ireland	Livestock and Meat Commission for Northern Ireland	government/organisations/livestock-and-meat-commission-for-northern-Ireland	Other		
local-better-regulation-office	Local Better Regulation Office	government/organisations/local-better-regulation-office	Other		01/04/2012
local-government-ombudsman	Local Government Ombudsman	government/organisations/local-government-ombudsman	Other		
london-and-continental-railways-ltd	London and Continental Railways Ltd	government/organisations/london-and-continental-railways-ltd	Public corporation		
london-thames-gateway-development-corporation	London Thames Gateway Development Corporation	government/organisations/london-thames-gateway-development-corporation	Executive non-departmental public body		28/02/2013
lord-chancellors-department	Lord Chancellor's Department	government/organisations/lord-chancellors-department	Ministerial department		12/06/2003
loughs-agency	Loughs Agency	government/organisations/loughs-agency	Other		
low-pay-commission	Low Pay Commission	government/organisations/low-pay-commission	Advisory non-departmental public body		
lyons-inquiry-into-local-government	Lyons Inquiry into Local Government	government/organisations/lyons-inquiry-into-local-government	Other		2007-03
macur-review	Macur Review	government/organisations/macur-review	Other		
marine-accident-investigation-branch	Marine Accident Investigation Branch	government/organisations/marine-accident-investigation-branch	Other		
marine-fisheries-agency	Marine Fisheries Agency	government/organisations/marine-fisheries-agency	Executive agency		01/04/2010
marine-management-organisation	Marine Management Organisation	government/organisations/marine-management-organisation	Executive non-departmental public body		
maritime-and-coastguard-agency	Maritime and Coastguard Agency	government/organisations/maritime-and-coastguard-agency	Executive agency		
marshall-aid-commemoration-commission	Marshall Aid Commemoration Commission	government/organisations/marshall-aid-commemoration-commission	Executive non-departmental public body		
mckay-commission	The McKay Commission	government/organisations/mckay-commission	Other		25/03/2013
meat-and-livestock-commission	Meat and Livestock Commission	government/organisations/meat-and-livestock-commission	Independent monitoring body		01/04/2008
meat-hygiene-service	Meat Hygiene Service	government/organisations/meat-hygiene-service	Executive agency		31/03/2010
medical-research-council	Medical Research Council	government/organisations/medical-research-council	Executive non-departmental public body		
medical-supplies-agency	Medical Supplies Agency	government/organisations/medical-supplies-agency	Executive agency		01/04/2005
medicines-and-healthcare-products-regulatory-agency	Medicines and Healthcare products Regulatory Agency	government/organisations/medicines-and-healthcare-products-regulatory-agency	Executive agency		
mental-health-act-commission	Mental Health Act Commission	government/organisations/mental-health-act-commission	Other		01/04/2009
mercantile-court	Mercantile Court	courts-tribunals/mercantile-court	Court		
met-office	Met Office	government/organisations/met-office	Executive agency		
mid-staffordshire-nhs-foundation-trust-public-inquiry	Mid Staffordshire NHS Foundation Trust Public Inquiry 2013	government/organisations/mid-staffordshire-nhs-foundation-trust-public-inquiry	Other		2013-02
mid-staffordshire-nhs-foundation-trust-public-inquiry-2010	Mid Staffordshire NHS Foundation Trust Public Inquiry 2010	government/organisations/mid-staffordshire-nhs-foundation-trust-public-inquiry-2010	Other		2010-02
migration-advisory-committee	Migration Advisory Committee	government/organisations/migration-advisory-committee	Advisory non-departmental public body		
military-aviation-authority	Military Aviation Authority	government/organisations/military-aviation-authority	Sub-organisation		
milk-development-council	Milk Development Council	government/organisations/milk-development-council	Other		01/04/2008
millennium-commission	Millennium Commission	government/organisations/millennium-commission	Other		30/11/2006
ministry-of-defence	Ministry of Defence	government/organisations/ministry-of-defence	Ministerial department		
ministry-of-defence-police-and-guarding-agency	Ministry of Defence Police and Guarding Agency	government/organisations/ministry-of-defence-police-and-guarding-agency	Executive agency		01/04/2013
ministry-of-justice	Ministry of Justice	government/organisations/ministry-of-justice	Ministerial department		
monitor	Monitor	government/organisations/monitor	Executive non-departmental public body		01/04/2016
monopolies-and-mergers-commission	Monopolies and Mergers Commission	government/organisations/monopolies-and-mergers-commission	Other		01/04/1999
morecambe-bay-investigation	Morecambe Bay Investigation	government/organisations/morecambe-bay-investigation	Other		
mull-of-kintyre-review	Mull of Kintyre Review	government/organisations/mull-of-kintyre-review	Other		2011
museums-libraries-and-archives-council	"Museums, Libraries and Archives Council"	government/organisations/museums-libraries-and-archives-council	Other		31/05/2012
national-army-museum	National Army Museum	government/organisations/national-army-museum	Executive non-departmental public body		
national-biological-standards-board	National Biological Standards Board	government/organisations/national-biological-standards-board	Executive agency		2008-07
national-blood-authority	National Blood Authority	government/organisations/national-blood-authority	Other		30/09/2005
national-care-standards-commission	National Care Standards Commission	government/organisations/national-care-standards-commission	Other		01/04/2004
national-college-for-school-leadership	National College for School Leadership	government/organisations/national-college-for-school-leadership	Executive agency		
national-college-for-teaching-and-leadership	National College for Teaching and Leadership	government/organisations/national-college-for-teaching-and-leadership	Executive agency		
national-counter-terrorism-security-office	National Counter Terrorism Security Office	government/organisations/national-counter-terrorism-security-office	Other		
national-crime-agency	National Crime Agency	government/organisations/national-crime-agency	Non-ministerial department		
national-crime-agency-remuneration-review-body	National Crime Agency Remuneration Review Body	government/organisations/national-crime-agency-remuneration-review-body	Other		
national-crime-squad	National Crime Squad	government/organisations/national-crime-squad	Other		01/04/2006
national-criminal-intelligence-service	National Criminal Intelligence Service	government/organisations/national-criminal-intelligence-service	Executive agency		01/04/2006
national-data-guardian	National Data Guardian	government/organisations/national-data-guardian	Other		
national-dna-database-ethics-group	National DNA Database Ethics Group	government/organisations/national-dna-database-ethics-group	Advisory non-departmental public body		
national-employer-advisory-board	National Employer Advisory Board	government/organisations/national-employer-advisory-board	Advisory non-departmental public body		
national-employment-savings-trust	National Employment Savings Trust (NEST) Corporation	government/organisations/national-employment-savings-trust	Executive non-departmental public body		
national-endowment-for-science-technology-and-the-arts	"National Endowment for Science, Technology and the Arts"	government/organisations/national-endowment-for-science-technology-and-the-arts	Other		closed
national-forest-company	National Forest Company	government/organisations/national-forest-company	Executive non-departmental public body		
national-fraud-authority	National Fraud Authority	government/organisations/national-fraud-authority	Executive agency		31/03/2014
national-gallery	National Gallery	government/organisations/national-gallery	Executive non-departmental public body		
national-heritage-memorial-fund	National Heritage Memorial Fund	government/organisations/national-heritage-memorial-fund	Executive non-departmental public body		
national-information-board	National Information Board	government/organisations/national-information-board	Other		
national-infrastructure-commission	National Infrastructure Commission	government/organisations/national-infrastructure-commission	Other		
national-institute-for-clinical-excellence	National Institute for Health and Care Excellence	government/organisations/national-institute-for-clinical-excellence	Executive non-departmental public body		
national-measurement-and-regulation-office	National Measurement and Regulation Office	government/organisations/national-measurement-and-regulation-office	Executive agency		
national-measurement-office	National Measurement Office	government/organisations/national-measurement-office	Executive agency		closed
national-museums-and-galleries-of-northern-ireland	National Museums and Galleries of Northern Ireland	government/organisations/national-museums-and-galleries-of-northern-Ireland	Other		
national-museums-liverpool	National Museums Liverpool	government/organisations/national-museums-liverpool	Executive non-departmental public body		
national-museums-of-scotland	National Museums of Scotland	government/organisations/national-museums-of-Scotland	Other		
national-offender-management-service	National Offender Management Service	government/organisations/national-offender-management-service	Executive agency		
national-patient-safety-agency	National Patient Safety Agency	government/organisations/national-patient-safety-agency	Executive agency		09/07/2012
national-policing-improvement-agency	National Policing Improvement Agency	government/organisations/national-policing-improvement-agency	Executive agency		2012-12
national-portrait-gallery	National Portrait Gallery	government/organisations/national-portrait-gallery	Executive non-departmental public body		
national-probation-service	National Probation Service	government/organisations/national-probation-service	Other		
national-radiological-protection-board	National Radiological Protection Board	government/organisations/national-radiological-protection-board	Other		01/04/2005
national-records-of-scotland	National Records of Scotland	government/organisations/national-records-of-Scotland	Other		
national-school-of-government	National School of Government	government/organisations/national-school-of-government	Other		
national-security	National security and intelligence	government/organisations/national-security	Sub-organisation		
national-treatment-agency-for-substance-misuse	National Treatment Agency for Substance Misuse	government/organisations/national-treatment-agency-for-substance-misuse	Executive agency		01/04/2013
national-weights-and-measures-laboratory	National Weights and Measures Laboratory	government/organisations/national-weights-and-measures-laboratory	Other		28/06/2007
natural-england	Natural England	government/organisations/natural-england	Executive non-departmental public body		
natural-environment-research-council	Natural Environment Research Council	government/organisations/natural-environment-research-council	Executive non-departmental public body		
natural-history-museum	Natural History Museum	government/organisations/natural-history-museum	Executive non-departmental public body		
natural-resources-institute	Natural Resources Institute	government/organisations/natural-resources-institute	Other		1996-05
natural-resources-wales	Natural Resources Wales	government/organisations/natural-resources-wales	Other		
nature-conservancy-council	Nature Conservancy Council	government/organisations/nature-conservancy-council	Other		1991
new-forest-national-park-authority	New Forest National Park Authority	government/organisations/new-forest-national-park-authority	Other		
new-opportunities-fund	New Opportunities Fund	government/organisations/new-opportunities-fund	Other		30/11/2006
nhs-appointments-commission	NHS Appointments Commission	government/organisations/nhs-appointments-commission	Other		31/10/2012
nhs-blood-and-transplant	NHS Blood and Transplant	government/organisations/nhs-blood-and-transplant	Executive non-departmental public body		
nhs-business-services-authority	NHS Business Services Authority	government/organisations/nhs-business-services-authority	Executive non-departmental public body		
nhs-commissioning-board	NHS England	government/organisations/nhs-commissioning-board	Executive non-departmental public body		
nhs-digital	NHS Digital	government/organisations/nhs-digital	Executive non-departmental public body		
nhs-direct-national-health-service-trust	NHS Direct National Health Service Trust	government/organisations/nhs-direct-national-health-service-trust	Other		closed
nhs-estates	NHS Estates	government/organisations/nhs-estates	Other		30/09/2005
nhs-improvement	NHS Improvement	government/organisations/nhs-improvement	Other		
nhs-information-centre	NHS Information Centre	government/organisations/nhs-information-centre	Other		01/04/2013
nhs-institute-for-innovation-and-improvement	NHS Institute for Innovation and Improvement	government/organisations/nhs-institute-for-innovation-and-improvement	Other		31/03/2013
nhs-litigation-authority	NHS Litigation Authority	government/organisations/nhs-litigation-authority	Executive non-departmental public body		
nhs-logistics-authority	NHS Logistics Authority	government/organisations/nhs-logistics-authority	Other		01/01/2006
nhs-pay-review-body	NHS Pay Review Body	government/organisations/nhs-pay-review-body	Advisory non-departmental public body		
nhs-pensions-agency	NHS Pensions Agency	government/organisations/nhs-pensions-agency	Executive agency		01/04/2006
nhs-professionals	NHS Professionals	government/organisations/nhs-professionals	Other		01/04/2010
nhs-purchasing-and-supply-agency	NHS Purchasing and Supply Agency	government/organisations/nhs-purchasing-and-supply-agency	Executive agency		31/03/2010
nhs-trust-development-authority	NHS Trust Development Authority	government/organisations/nhs-trust-development-authority	Executive non-departmental public body		
nhs-wales-informatics-service	NHS Wales Informatics Service	government/organisations/nhs-wales-informatics-service	Other		
nimrod-review	Nimrod Review	government/organisations/nimrod-review	Other		2009-10
north-east-derbyshire-coalfields-education-action-zone	North East Derbyshire Coalfields Education Action Zone	government/organisations/north-east-derbyshire-coalfields-education-action-zone	Other		30/11/2004
north-east-education-and-library-board	North East Education and Library Board	government/organisations/north-east-education-and-library-board	Other		
north-gillingham-education-action-zone	North Gillingham Education Action Zone	government/organisations/north-gillingham-education-action-zone	Other		09/01/2005
north-islington-education-action-zone	North Islington Education Action Zone	government/organisations/north-islington-education-action-zone	Other		30/11/2004
north-stockton-education-action-zone	North Stockton Education Action Zone	government/organisations/north-stockton-education-action-zone	Other		16/04/2005
north-west-development-agency	North West Development Agency	government/organisations/north-west-development-agency	Executive agency		31/03/2012
north-west-shropshire-education-action-zone	North West Shropshire Education Action Zone	government/organisations/north-west-shropshire-education-action-zone	Other		02/04/2005
north-york-moors-national-park	North York Moors National Park Authority	government/organisations/north-york-moors-national-park	Other		
northampton-county-court-business-centre	Northampton County Court Business Centre	courts-tribunals/northampton-county-court-business-centre	Court		
northern-health-and-social-services-board	Northern Health and Social Services Board	government/organisations/northern-health-and-social-services-board	Other		closed
northern-ireland-audit-office	Northern Ireland Audit Office	government/organisations/northern-Ireland-audit-office	Other		
northern-ireland-authority-for-energy-regulation	Northern Ireland Authority for Energy Regulation	government/organisations/northern-Ireland-authority-for-energy-regulation	Other		
northern-ireland-child-support-agency	Northern Ireland Child Support Agency	government/organisations/northern-Ireland-child-support-agency	Executive agency		
northern-ireland-commissioner-for-children-and-young-people	Northern Ireland Commissioner for Children and Young People	government/organisations/northern-Ireland-commissioner-for-children-and-young-people	Other		
northern-ireland-council-for-the-curriculum-examinations-and-assessment	"Northern Ireland Council for the Curriculum, Examinations and Assessment"	government/organisations/northern-Ireland-council-for-the-curriculum-examinations-and-assessment	Other		
northern-ireland-court-service	Northern Ireland Court Service	government/organisations/northern-Ireland-court-service	Other		
northern-ireland-executive	Northern Ireland Executive	government/organisations/northern-Ireland-executive	Devolved administration		
northern-ireland-health-and-social-services-estates-agency	Northern Ireland Health and Social Services Estates Agency	government/organisations/northern-Ireland-health-and-social-services-estates-agency	Other		
northern-ireland-human-rights-commission	Northern Ireland Human Rights Commission	government/organisations/northern-Ireland-human-rights-commission	Executive non-departmental public body		
northern-ireland-judicial-appointments-commission	Northern Ireland Judicial Appointments Commission	government/organisations/northern-Ireland-judicial-appointments-commission	Other		
northern-ireland-judicial-appointments-ombudsman	Northern Ireland Judicial Appointments Ombudsman	government/organisations/northern-Ireland-judicial-appointments-ombudsman	Other		
northern-ireland-law-commission	Northern Ireland Law Commission	government/organisations/northern-Ireland-law-commission	Other		
northern-ireland-legal-services-commission	Northern Ireland Legal Services Commission	government/organisations/northern-Ireland-legal-services-commission	Other		
northern-ireland-local-government-officers-superannuation-committee	Northern Ireland Local Government Officers' Superannuation Committee	government/organisations/northern-Ireland-local-government-officers-superannuation-committee	Other		
northern-ireland-office	Northern Ireland Office	government/organisations/northern-Ireland-office	Ministerial department		
northern-ireland-ombudsman	Northern Ireland Ombudsman	government/organisations/northern-Ireland-ombudsman	Other		
northern-ireland-police-fund	Northern Ireland Police Fund	government/organisations/northern-Ireland-police-fund	Other		12/04/2010
northern-ireland-policing-board	Northern Ireland Policing Board	government/organisations/northern-Ireland-policing-board	Other		
northern-ireland-practice-and-education-council	Northern Ireland Practice and Education Council	government/organisations/northern-Ireland-practice-and-education-council	Other		
northern-ireland-prison-service	Northern Ireland Prison Service	government/organisations/northern-Ireland-prison-service	Executive agency		
northern-ireland-social-care-council	Northern Ireland Social Care Council	government/organisations/northern-ireland-social-care-council	Other		
northern-ireland-social-security-agency	Northern Ireland Social Security Agency	government/organisations/northern-Ireland-social-security-agency	Executive agency		
northern-ireland-statistics-and-research-agency	Northern Ireland Statistics and Research Agency	government/organisations/northern-Ireland-statistics-and-research-agency	Executive agency		
northern-ireland-tourist-board	Northern Ireland Tourist Board	government/organisations/northern-Ireland-tourist-board	Other		
northern-lighthouse-board	Northern Lighthouse Board	government/organisations/northern-lighthouse-board	Executive non-departmental public body		
northumberland-national-park-authority	Northumberland National Park Authority	government/organisations/Northumberland-national-park-authority	Other		
northwest-business-link	Northwest Business Link	government/organisations/northwest-business-link	Executive agency		23/01/2014
northwest-regional-development-agency	Northwest Regional Development Agency	government/organisations/northwest-regional-development-agency	Executive agency		01/07/2012
ns-i	NS&I	government/organisations/ns-i	Non-ministerial department		
nuclear-decommissioning-authority	Nuclear Decommissioning Authority	government/organisations/nuclear-decommissioning-authority	Executive non-departmental public body		
nuclear-liabilities-financing-assurance-board	Nuclear Liabilities Financing Assurance Board	government/organisations/nuclear-liabilities-financing-assurance-board	Advisory non-departmental public body		
nuclear-research-advisory-council	Nuclear Research Advisory Council	government/organisations/nuclear-research-advisory-council	Advisory non-departmental public body		
ofcom	Ofcom	government/organisations/ofcom	Other		
office-for-budget-responsibility	Office for Budget Responsibility	government/organisations/office-for-budget-responsibility	Executive non-departmental public body		
office-for-criminal-justice-reform	Office for Criminal Justice Reform	government/organisations/office-for-criminal-justice-reform	Other		closed
office-for-disability-issues	Office for Disability Issues	government/organisations/office-for-disability-issues	Sub-organisation		closed
office-for-fair-access	Office for Fair Access	government/organisations/office-for-fair-access	Executive non-departmental public body		
office-for-life-sciences	Office for Life Sciences	government/organisations/office-for-life-sciences	Sub-organisation		
office-for-low-emission-vehicles	Office for Low Emission Vehicles	government/organisations/office-for-low-emission-vehicles	Sub-organisation		
office-for-national-statistics	Office for National Statistics	government/organisations/office-for-national-statistics	Other		
office-for-nuclear-regulation	Office for Nuclear Regulation	government/organisations/office-for-nuclear-regulation	Public corporation		
office-for-tenants-and-social-landlords	Office for Tenants and Social Landlords	government/organisations/office-for-tenants-and-social-landlords	Executive agency		2012
office-of-fair-trading	Office of Fair Trading	government/organisations/office-of-fair-trading	Non-ministerial department		01/04/2014
office-of-financial-sanctions-implementation	Office of Financial Sanctions Implementation	government/organisations/office-of-financial-sanctions-implementation	Sub-organisation		
office-of-hm-paymaster-general	Office of HM Paymaster General	government/organisations/office-of-hm-paymaster-general	Other		01/04/2008
office-of-manpower-economics	Office of Manpower Economics	government/organisations/office-of-manpower-economics	Other		
office-of-rail-and-road	Office of Rail and Road	government/organisations/office-of-rail-and-road	Non-ministerial department		
office-of-rail-regulation	Office of Rail Regulation	government/organisations/office-of-rail-regulation	Non-ministerial department		
office-of-surveillance-commissioners	Office of Surveillance Commissioners	government/organisations/office-of-surveillance-commissioners	Tribunal non-departmental public body		
office-of-tax-simplification	Office of Tax Simplification	government/organisations/office-of-tax-simplification	Sub-organisation		
office-of-telecommunications	Office of Telecommunications	government/organisations/office-of-telecommunications	Other		29/12/2003
office-of-the-advocate-general-for-scotland	Office of the Advocate General for Scotland	government/organisations/office-of-the-advocate-general-for-Scotland	Ministerial department		
office-of-the-chief-electoral-officer-for-northern-ireland	Office of the Chief Electoral Officer for Northern Ireland	government/organisations/office-of-the-chief-electoral-officer-for-northern-Ireland	Other		
office-of-the-children-s-commissioner	Office of the Children's Commissioner	government/organisations/office-of-the-children-s-commissioner	Executive non-departmental public body		
office-of-the-commissioner-for-protection-against-unlawful-industrial-action	Office of the Commissioner for Protection Against Unlawful Industrial Action	government/organisations/office-of-the-commissioner-for-protection-against-unlawful-industrial-action	Other		25/10/1999
office-of-the-commissioner-for-the-rights-of-trade-union-members	Office of the Commissioner for the Rights of Trade Union Members	government/organisations/office-of-the-commissioner-for-the-rights-of-trade-union-members	Other		
office-of-the-data-protection-registrar	Office of the Data Protection Registrar	government/organisations/office-of-the-data-protection-registrar	Other		1998
office-of-the-first-minister-and-deputy-first-minister	Office of the First Minister and Deputy First Minister	government/organisations/office-of-the-first-minister-and-deputy-first-minister	Other		
office-of-the-health-professions-adjudicator	Office of the Health Professions Adjudicator	government/organisations/office-of-the-health-professions-adjudicator	Other		30/06/2012
office-of-the-identity-commissioner	Office of the Identity Commissioner	government/organisations/office-of-the-identity-commissioner	Other		2010-12
office-of-the-immigration-services-commissioner	Office of the Immigration Services Commissioner	government/organisations/office-of-the-immigration-services-commissioner	Executive non-departmental public body		
office-of-the-lay-observer	Office of the Lay Observer	government/organisations/office-of-the-lay-observer	Other		
office-of-the-leader-of-the-house-of-lords	Office of the Leader of the House of Lords	government/organisations/office-of-the-leader-of-the-house-of-lords	Ministerial department		
office-of-the-legal-services-complaints-commissioner	Office of the Legal Services Complaints Commissioner	government/organisations/office-of-the-legal-services-complaints-commissioner	Other		
office-of-the-legal-services-ombudsman	Office of the Legal Services Ombudsman	government/organisations/office-of-the-legal-services-ombudsman	Other		2011
office-of-the-oversight-commissioner	Office of the Oversight Commissioner	government/organisations/office-of-the-oversight-commissioner	Other		31/05/2007
office-of-the-parliamentary-counsel	Office of the Parliamentary Counsel	government/organisations/office-of-the-parliamentary-counsel	Sub-organisation		
office-of-the-police-ombudsman-for-northern-ireland	Office of the Police Ombudsman for Northern Ireland	government/organisations/office-of-the-police-ombudsman-for-northern-Ireland	Other		
office-of-the-public-guardian	Office of the Public Guardian	government/organisations/office-of-the-public-guardian	Executive agency		
office-of-the-registrar-of-consultant-lobbyists	Office of the Registrar of Consultant Lobbyists	government/organisations/office-of-the-registrar-of-consultant-lobbyists	Other		
office-of-the-regulator-of-community-interest-companies	Office of the Regulator of Community Interest Companies	government/organisations/office-of-the-regulator-of-community-interest-companies	Other		
office-of-the-schools-adjudicator	Office of the Schools Adjudicator	government/organisations/office-of-the-schools-adjudicator	Other		
official-solicitor-and-public-trustee	Official Solicitor and Public Trustee	government/organisations/official-solicitor-and-public-trustee	Other		
ofgem	Ofgem	government/organisations/ofgem	Non-ministerial department		
ofqual	Ofqual	government/organisations/ofqual	Non-ministerial department		
ofsted	Ofsted	government/organisations/ofsted	Non-ministerial department		
oftel	Oftel	government/organisations/oftel	Other		2003
ogcbuyingsolutions	OGCbuyingsolutions	government/organisations/ogcbuyingsolutions	Other		15/06/2010
oil-and-gas-authority	Oil and Gas Authority	government/organisations/oil-and-gas-authority	Other		
oil-and-pipelines-agency	The Oil and Pipelines Agency	government/organisations/oil-and-pipelines-agency	Public corporation		
olympic-delivery-authority	Olympic Delivery Authority	government/organisations/olympic-delivery-authority	Executive non-departmental public body		02/12/2014
one-north-east	One North East	government/organisations/one-north-east	Executive agency		30/06/2012
open-public-services	Open Public Services	government/organisations/open-public-services	Sub-organisation		
ordnance-survey	Ordnance Survey	government/organisations/ordnance-survey	Non-ministerial department		
ordnance-survey-of-northern-ireland	Ordnance Survey of Northern Ireland	government/organisations/ordnance-survey-of-northern-Ireland	Executive agency		
parades-commission-for-northern-ireland	Parades Commission for Northern Ireland	government/organisations/parades-commission-for-northern-Ireland	Executive non-departmental public body		
parliamentary-contributory-pension-fund	Parliamentary Contributory Pension Fund	government/organisations/parliamentary-contributory-pension-fund	Other		closed maybe
parole-board	Parole Board	government/organisations/parole-board	Executive non-departmental public body		
parole-commissioners-for-northern-ireland	Parole Commissioners for Northern Ireland	government/organisations/parole-commissioners-for-northern-Ireland	Other		
particle-physics-and-astronomy-research-council	Particle Physics and Astronomy Research Council	government/organisations/particle-physics-and-astronomy-research-council	Other		01/04/2007
passenger-focus	Passenger Focus	government/organisations/passenger-focus	Executive non-departmental public body		closed
patents-court	Patents Court	courts-tribunals/patents-court	Court		
patrick-finucane-review	Patrick Finucane Review	government/organisations/patrick-finucane-review	Other		2015-01
payment-systems-regulator	Payment Systems Regulator	government/organisations/payment-systems-regulator	Other		
peak-district-national-park	Peak District National Park Authority	government/organisations/peak-district-national-park	Other		
pension-disability-and-carers-service	"Pension, Disability and Carers Service"	government/organisations/pension-disability-and-carers-service	Executive agency		
pension-protection-fund	Pension Protection Fund	government/organisations/pension-protection-fund	Public corporation		
pension-protection-fund-ombudsman	Pension Protection Fund Ombudsman	government/organisations/pension-protection-fund-ombudsman	Tribunal non-departmental public body		
pension-service	Pension Service	government/organisations/pension-service	Executive agency		
pensions-ombudsman	Pensions Ombudsman	government/organisations/pensions-ombudsman	Tribunal non-departmental public body		
people-pay-and-pensions-agency	"People, Pay and Pensions Agency"	government/organisations/people-pay-and-pensions-agency	Executive agency		06/07/2011
personal-accounts-delivery-authority	Personal Accounts Delivery Authority	government/organisations/personal-accounts-delivery-authority	Other		05/07/2010
pesticides-safety-directorate	Pesticides Safety Directorate	government/organisations/pesticides-safety-directorate	Other		2008
peterlee-education-action-zone	Peterlee Education Action Zone	government/organisations/peterlee-education-action-zone	Other		09/01/2005
phoenix-sports	Phoenix Sports	government/organisations/phoenix-sports	Other		closed
planning-court	Planning Court	courts-tribunals/planning-court	Court		
planning-inspectorate	Planning Inspectorate	government/organisations/planning-inspectorate	Executive agency		
planning-service	Planning Service	government/organisations/planning-service	Other		
plant-varieties-and-seeds-tribunal	Plant Varieties and Seeds Tribunal	government/organisations/plant-varieties-and-seeds-tribunal	Tribunal non-departmental public body		
plymouth-education-action-zone	Plymouth Education Action Zone	government/organisations/plymouth-education-action-zone	Other		31/12/2003
police-advisory-board-for-england-and-wales	Police Advisory Board for England and Wales	government/organisations/police-advisory-board-for-england-and-wales	Advisory non-departmental public body		
police-arbitration-tribunal	Police Arbitration Tribunal	government/organisations/police-arbitration-tribunal	Tribunal non-departmental public body		closed
police-complaints-authority	Police Complaints Authority	government/organisations/police-complaints-authority	Other		31/03/2004
police-discipline-appeals-tribunal	Police Discipline Appeals Tribunal	government/organisations/police-discipline-appeals-tribunal	Tribunal non-departmental public body		
police-information-technology-organisation	Police Information Technology Organisation	government/organisations/police-information-technology-organisation	Executive agency		31/03/2007
police-negotiating-board	Police Negotiating Board	government/organisations/police-negotiating-board	Advisory non-departmental public body		01/10/2014
police-remuneration-review-body	Police Remuneration Review Body	government/organisations/police-remuneration-review-body	Advisory non-departmental public body		
police-service-of-northern-ireland	Police Service of Northern Ireland	government/organisations/police-service-of-northern-Ireland	Other		
polytechnics-and-colleges-funding-council	Polytechnics and Colleges Funding Council	government/organisations/polytechnics-and-colleges-funding-council	Other		1992
porton-biopharma-limited	Porton Biopharma Limited	government/organisations/porton-biopharma-limited	Other		
postal-services-commission	Postal Services Commission	government/organisations/postal-services-commission	Other		01/10/2011
postgraduate-medical-education-and-training-board	Postgraduate Medical Education and Training Board	government/organisations/postgraduate-medical-education-and-training-board	Other		01/04/2010
prescription-pricing-authority	Prescription Pricing Authority	government/organisations/prescription-pricing-authority	Other		01/04/2006
prime-ministers-office-10-downing-street	"Prime Minister's Office, 10 Downing Street"	government/organisations/prime-ministers-office-10-downing-street	Executive office		
prison-services-pay-review-body	Prison Service Pay Review Body	government/organisations/prison-services-pay-review-body	Advisory non-departmental public body		
prisons-and-probation-ombudsman	Prisons and Probation Ombudsman	government/organisations/prisons-and-probation-ombudsman	Other		
privy-council-office	Privy Council Office	government/organisations/privy-council-office	Other		
probation-board-for-northern-ireland	Probation Board for Northern Ireland	government/organisations/probation-board-for-northern-Ireland	Other		
professional-oversight-board	Professional Oversight Board	government/organisations/professional-oversight-board	Other		02/07/2012
professional-standards-authority-for-health-and-social-care	Professional Standards Authority for Health and Social Care	government/organisations/professional-standards-authority-for-health-and-social-care	Other		
public-accounts-commission	Public Accounts Commission	government/organisations/public-accounts-commission	Other		
public-health-england	Public Health England	government/organisations/public-health-england	Executive agency		
public-health-laboratory-service-board	Public Health Laboratory Service Board	government/organisations/public-health-laboratory-service-board	Executive agency		02/08/2004
public-health-wales	Public Health Wales	government/organisations/public-health-wales	Other		
public-lending-right-office	Public Lending Right Office	government/organisations/public-lending-right-office	Other		01/10/2013
public-prosecution-service-for-northern-ireland	Public Prosecution Service for Northern Ireland	government/organisations/public-prosecution-service-for-northern-Ireland	Other		
pubs-code-adjudicator	Pubs Code Adjudicator	government/organisations/pubs-code-adjudicator	Other		
qualifications-and-curriculum-authority	Qualifications and Curriculum Authority	government/organisations/qualifications-and-curriculum-authority	Executive agency		01/04/2010
qualifications-and-curriculum-development-agency	Qualifications and Curriculum Development Agency	government/organisations/qualifications-and-curriculum-development-agency	Executive agency		01/04/2012
queen-elizabeth-ii-conference-centre	Queen Elizabeth II Conference Centre	government/organisations/queen-elizabeth-ii-conference-centre	Executive agency		
queens-bench-division-of-the-high-court	Queen's Bench Division of the High Court	courts-tribunals/queens-bench-division-of-the-high-court	Court		
queens-harbour-master	Queen's Harbour Master	government/organisations/queens-harbour-master	Sub-organisation		
radioactive-waste-management	Radioactive Waste Management	government/organisations/radioactive-waste-management	Other		
rail-accident-investigation-branch	Rail Accident Investigation Branch	government/organisations/rail-accident-investigation-branch	Other		
railway-heritage-committee	Railway Heritage Committee	government/organisations/railway-heritage-committee	Executive non-departmental public body		01/04/2013
redfern-inquiry	Redfern Inquiry	government/organisations/redfern-inquiry	Other		2010-11
regeneration-investment-organisation	Regeneration Investment Organisation	government/organisations/regeneration-investment-organisation	Sub-organisation		
regulatory-delivery	Regulatory Delivery	government/organisations/regulatory-delivery	Sub-organisation		
regulatory-policy-committee	Regulatory Policy Committee	government/organisations/regulatory-policy-committee	Advisory non-departmental public body		
remploy-ltd	Remploy Ltd	government/organisations/remploy-ltd	Executive non-departmental public body		closed
renewable-fuels-agency	Renewable Fuels Agency	government/organisations/renewable-fuels-agency	Executive agency		01/04/2011
rent-service	Rent Service	government/organisations/rent-service	Executive agency		01/04/2009
reserve-forces-and-cadets-associations	Reserve Forces' and Cadets' Associations	government/organisations/reserve-forces-and-cadets-associations	Other		
reserve-forces-appeal-tribunal	Reserve Forces Appeal Tribunal	courts-tribunals/reserve-forces-appeal-tribunal	Tribunal non-departmental public body		
revenue-and-customs-prosecutions-office	Revenue and Customs Prosecutions Office	government/organisations/revenue-and-customs-prosecutions-office	Other		2010-04
review-board-for-government-contracts	Review Board for Government Contracts	government/organisations/review-board-for-government-contracts	Advisory non-departmental public body		31/03/2015
review-body-for-nursing-and-other-health-professions	Review Body for Nursing and Other Health Professions	government/organisations/review-body-for-nursing-and-other-health-professions	Other		closed
review-body-on-doctors-and-dentists-remuneration	Review Body on Doctors' and Dentists' Remuneration	government/organisations/review-body-on-doctors-and-dentists-remuneration	Advisory non-departmental public body		
review-body-on-senior-salaries	Senior Salaries Review Body	government/organisations/review-body-on-senior-salaries	Advisory non-departmental public body		
rivers-agency	Rivers Agency	government/organisations/rivers-agency	Executive agency		
roads-service	Roads Service	government/organisations/roads-service	Other		
rosemary-nelson-inquiry	Rosemary Nelson Inquiry	government/organisations/rosemary-nelson-inquiry	Other		23/05/2011
royal-air-force-museum	Royal Air Force Museum	government/organisations/royal-air-force-museum	Executive non-departmental public body		
royal-armouries-museum	Royal Armouries Museum	government/organisations/royal-armouries-museum	Executive non-departmental public body		
royal-commission-on-criminal-justice	Royal Commission on Criminal Justice	government/organisations/royal-commission-on-criminal-justice	Other		1993
royal-commission-on-environmental-pollution	Royal Commission on Environmental Pollution	government/organisations/royal-commission-on-environmental-pollution	Other		01/04/2011
royal-liverpool-childrens-inquiry	Royal Liverpool Childrens Inquiry	government/organisations/royal-liverpool-childrens-inquiry	Other		30/01/2001
royal-mail	Royal Mail	government/organisations/royal-mail	Public corporation		
royal-marines-museum	Royal Marines Museum	government/organisations/royal-marines-museum	Other		
royal-mint	Royal Mint	government/organisations/royal-mint	Other		
royal-mint-advisory-committee	Royal Mint Advisory Committee	government/organisations/royal-mint-advisory-committee	Advisory non-departmental public body		
royal-museums-greenwich	Royal Museums Greenwich	government/organisations/royal-museums-greenwich	Executive non-departmental public body		
royal-naval-museum	National Museum of the Royal Navy	government/organisations/royal-naval-museum	Executive non-departmental public body		
royal-navy-submarine-museum	Royal Navy Submarine Museum	government/organisations/royal-navy-submarine-museum	Other		
royal-parks	Royal Parks	government/organisations/royal-parks	Executive agency		
royal-trustees-office	Royal Trustees' Office	government/organisations/royal-trustees-office	Other		2012
rural-development-programme-for-england-network	Rural Development Programme for England Network	government/organisations/rural-development-programme-for-england-network	Sub-organisation		
rural-payments-agency	Rural Payments Agency	government/organisations/rural-payments-agency	Executive agency		
s4c	S4C	government/organisations/s4c	Other		
school-food-trust	School Food Trust	government/organisations/school-food-trust	Other		01/10/2011
school-teachers-review-body	School Teachers' Review Body	government/organisations/school-teachers-review-body	Advisory non-departmental public body		
schools-commissioners-group	Schools Commissioners Group	government/organisations/schools-commissioners-group	Sub-organisation		
science-advisory-committee-on-the-medical-implications-of-less-lethal-weapons	Scientific Advisory Committee on the Medical Implications of Less-Lethal Weapons	government/organisations/science-advisory-committee-on-the-medical-implications-of-less-lethal-weapons	Advisory non-departmental public body		
science-advisory-council	Science Advisory Council	government/organisations/science-advisory-council	Advisory non-departmental public body		
science-and-technology-facilities-council	Science and Technology Facilities Council	government/organisations/science-and-technology-facilities-council	Executive non-departmental public body		
science-museum-group	Science Museum Group	government/organisations/science-museum-group	Executive non-departmental public body		
scotland-office	Scotland Office	government/organisations/Scotland-office	Ministerial department		
scottish-arts-council	Scottish Arts Council	government/organisations/scottish-arts-council	Other		01/07/2010
scottish-hospital-trust	Scottish Hospital Trust	government/organisations/scottish-hospital-trust	Other		closed
scottish-law-commission	Scottish Law Commission	government/organisations/scottish-law-commission	Other		
scottish-office	Scottish Office	government/organisations/scottish-office	Ministerial department		1999
scottish-screen	Scottish Screen	government/organisations/scottish-screen	Other		01/07/2010
scottish-sports-council	Scottish Sports Council	government/organisations/scottish-sports-council	Executive agency		
sea-fish-industry-authority	Sea Fish Industry Authority	government/organisations/sea-fish-industry-authority	Executive non-departmental public body		
secret-intelligence-service	Secret Intelligence Service	government/organisations/secret-intelligence-service	Other		
security-industry-authority	Security Industry Authority	government/organisations/security-industry-authority	Executive non-departmental public body		
security-vetting-appeals-panel	Security Vetting Appeals Panel	government/organisations/security-vetting-appeals-panel	Advisory non-departmental public body		
senior-courts-costs-office	Senior Courts Costs Office	courts-tribunals/senior-courts-costs-office	Court		
sentence-review-commissioners	Sentence Review Commissioners	government/organisations/sentence-review-commissioners	Other		closed
serious-fraud-office	Serious Fraud Office	government/organisations/serious-fraud-office	Non-ministerial department		
serious-organised-crime-agency	Serious Organised Crime Agency	government/organisations/serious-organised-crime-agency	Executive non-departmental public body		07/10/2013
service-children-s-education	Service Children's Education	government/organisations/service-children-s-education	Executive agency		
service-complaints-commissioner	Service Complaints Commissioner	government/organisations/service-complaints-commissioner	Other		2016-01
service-complaints-ombudsman	Service Complaints Ombudsman	government/organisations/service-complaints-ombudsman	Other		
service-personnel-and-veterans-agency	Service Personnel and Veterans Agency	government/organisations/service-personnel-and-veterans-agency	Executive agency		01/04/2014
service-prosecuting-authority	Service Prosecuting Authority	government/organisations/service-prosecuting-authority	Other		
shipman-inquiry	Shipman Inquiry	government/organisations/shipman-inquiry	Other		27/01/2005
single-source-regulations-office	Single Source Regulations Office	government/organisations/single-source-regulations-office	Executive non-departmental public body		
sir-john-soane-s-museum	Sir John Soane's Museum	government/organisations/sir-john-soane-s-museum	Executive non-departmental public body		
sitpro	SITPRO	government/organisations/sitpro	Other		30/11/2010
skills-funding-agency	Skills Funding Agency	government/organisations/skills-funding-agency	Executive agency		
social-mobility-and-child-poverty-commission	Social Mobility and Child Poverty Commission	government/organisations/social-mobility-and-child-poverty-commission	Advisory non-departmental public body		
social-mobility-commission	Social Mobility Commission	government/organisations/social-mobility-commission	Advisory non-departmental public body		
social-science-research-committee	Social Science Research Committee	government/organisations/social-science-research-committee	Advisory non-departmental public body		
social-security-advisory-committee	Social Security Advisory Committee	government/organisations/social-security-advisory-committee	Advisory non-departmental public body		
social-security-agency	Social Security Agency	government/organisations/social-security-agency	Executive agency		
south-bradford-education-action-zone	South Bradford Education Action Zone	government/organisations/south-bradford-education-action-zone	Other		09/01/2005
south-downs-national-park-authority	South Downs National Park Authority	government/organisations/south-downs-national-park-authority	Other		
south-east-england-development-agency	South East England Development Agency	government/organisations/south-east-england-development-agency	Executive agency		2012
south-east-england-virtual-education-action-zone	South East England Virtual Education Action Zone	government/organisations/south-east-england-virtual-education-action-zone	Other		02/04/2005
south-east-sheffield-education-action-zone	South East Sheffield Education Action Zone	government/organisations/south-east-sheffield-education-action-zone	Other		16/04/2005
south-eastern-education-and-library-board	South Eastern Education and Library Board	government/organisations/south-eastern-education-and-library-board	Other		
south-west-of-england-regional-development-agency	South West of England Regional Development Agency	government/organisations/south-west-of-england-regional-development-agency	Executive agency		2012
southend-education-action-zone	Southend Education Action Zone	government/organisations/southend-education-action-zone	Other		30/11/2004
southern-health-and-social-services-board	Southern Health and Social Services Board	government/organisations/southern-health-and-social-services-board	Other		closed
special-eu-programmes-body	Special EU Programmes Body	government/organisations/special-eu-programmes-body	Other		
speke-garston-education-action-zone	Speke Garston Education Action Zone	government/organisations/speke-garston-education-action-zone	Other		09/01/2005
sport-england	Sport England	government/organisations/sport-england	Executive non-departmental public body		
sports-council-for-northern-ireland	Sports Council for Northern Ireland	government/organisations/sports-council-for-northern-Ireland	Other		
sports-council-for-wales	Sports Council for Wales	government/organisations/sports-council-for-wales	Other		
sports-grounds-safety-authority	Sports Grounds Safety Authority	government/organisations/sports-grounds-safety-authority	Executive non-departmental public body		
stabilisation-unit	Stabilisation Unit	government/organisations/stabilisation-unit	Other		
staff-commission-for-education-and-library-boards	Staff Commission for Education and Library Boards	government/organisations/staff-commission-for-education-and-library-boards	Other		
standards-and-testing-agency	Standards and Testing Agency	government/organisations/standards-and-testing-agency	Executive agency		
standards-board-for-england	Standards Board for England	government/organisations/standards-board-for-england	Other		31/01/2012
state-veterinary-service	State Veterinary Service	government/organisations/state-veterinary-service	Other		2007
statistics-commission	Statistics Commission	government/organisations/statistics-commission	Other		01/04/2008
stoke-education-action-zone	Stoke Education Action Zone	government/organisations/stoke-education-action-zone	Other		09/01/2005
strategic-rail-authority	Strategic Rail Authority	government/organisations/strategic-rail-authority	Other		30/11/2006
student-loans-company	Student Loans Company	government/organisations/student-loans-company	Executive non-departmental public body		
sunderland-education-action-zone	Sunderland Education Action Zone	government/organisations/sunderland-education-action-zone	Other		09/01/2005
supreme-court-of-the-united-kingdom	Supreme Court of the United Kingdom	government/organisations/supreme-court-of-the-united-kingdom	Non-ministerial department		
surveillance-camera-commissioner	Surveillance Camera Commissioner	government/organisations/surveillance-camera-commissioner	Other		
sutherland-inquiry	Sutherland Inquiry	government/organisations/sutherland-inquiry	Other		17/12/2008
tate	Tate	government/organisations/tate	Executive non-departmental public body		
technical-advisory-board	Technical Advisory Board	government/organisations/technical-advisory-board	Advisory non-departmental public body		
technology-and-construction-court	Technology and Construction Court	courts-tribunals/technology-and-construction-court	Court		
technology-strategy-board	Technology Strategy Board	government/organisations/technology-strategy-board	Executive non-departmental public body		closed
telford-and-wrekin-education-action-zone	Telford and Wrekin Education Action Zone	government/organisations/telford-and-wrekin-education-action-zone	Other		30/11/2004
tenant-services-authority	Tenant Services Authority	government/organisations/tenant-services-authority	Executive agency		2010-10
the-adjudicator-s-office	The AdjudicatorÕs Office	government/organisations/the-adjudicator-s-office	Other		
the-advisory-council-on-national-records-and-archives	The Advisory Council on National Records and Archives	government/organisations/the-advisory-council-on-national-records-and-archives	Advisory non-departmental public body		
the-coal-authority	Coal Authority	government/organisations/the-coal-authority	Executive non-departmental public body		
the-committee-on-standards-in-public-life	Committee on Standards in Public Life	government/organisations/the-committee-on-standards-in-public-life	Advisory non-departmental public body		
the-crown-estate	The Crown Estate	government/organisations/the-crown-estate	Other		
the-electoral-commission	The Electoral Commission	government/organisations/the-electoral-commission	Independent monitoring body		
the-executive-office-northern-ireland	The Executive Office (Northern Ireland)	government/organisations/the-executive-office-northern-Ireland	Other		
the-food-and-environment-research-agency	The Food and Environment Research Agency	government/organisations/the-food-and-environment-research-agency	Executive agency		closed
the-fuel-poverty-advisory-group	Fuel Poverty Advisory Group	government/organisations/the-fuel-poverty-advisory-group	Advisory non-departmental public body		
the-legal-ombudsman	The Legal Ombudsman	government/organisations/the-legal-ombudsman	Other		
the-national-archives	The National Archives	government/organisations/the-national-archives	Non-ministerial department		
the-office-of-the-leader-of-the-house-of-commons	Office of the Leader of the House of Commons	government/organisations/the-office-of-the-leader-of-the-house-of-commons	Ministerial department		
the-parliamentary-and-health-service-ombudsman	The Parliamentary and Health Service Ombudsman	government/organisations/the-parliamentary-and-health-service-ombudsman	Other		
the-pensions-advisory-service	The Pensions Advisory Service	government/organisations/the-pensions-advisory-service	Executive non-departmental public body		
the-pensions-regulator	The Pensions Regulator	government/organisations/the-pensions-regulator	Executive non-departmental public body		
the-reviewing-committee-on-the-export-of-works-of-art-and-objects-of-cultural-interest	The Reviewing Committee on the Export of Works of Art and Objects of Cultural Interest	government/organisations/the-reviewing-committee-on-the-export-of-works-of-art-and-objects-of-cultural-interest	Advisory non-departmental public body		
the-scottish-government	The Scottish Government	government/organisations/the-scottish-government	Devolved administration		
the-security-service-mi5	The Security Service	government/organisations/the-security-service-mi5	Other		
the-sentencing-council-for-england-and-wales	Sentencing Council for England and Wales	government/organisations/the-sentencing-council-for-england-and-wales	Advisory non-departmental public body		
the-shareholder-executive	The Shareholder Executive	government/organisations/the-shareholder-executive	Other		2016-04
the-theatres-trust	The Theatres Trust	government/organisations/the-theatres-trust	Advisory non-departmental public body		
the-water-services-regulation-authority	The Water Services Regulation Authority	government/organisations/the-water-services-regulation-authority	Non-ministerial department		
the-west-northamptonshire-development-corporation	West Northamptonshire Development Corporation	government/organisations/the-west-northamptonshire-development-corporation	Executive non-departmental public body		13/07/2014
third-party-campaigning-review	Third Party Campaigning Review	government/organisations/third-party-campaigning-review	Other		17/03/2016
thurrock-thames-gateway-development-corporation	Thurrock Thames Gateway Development Corporation	government/organisations/thurrock-thames-gateway-development-corporation	Other		31/10/2012
traffic-commissioners	Traffic Commissioners for Great Britain	government/organisations/traffic-commissioners	Tribunal non-departmental public body		
training-and-development-agency-for-schools	Training and Development Agency for Schools	government/organisations/training-and-development-agency-for-schools	Executive agency		01/04/2012
transport-focus	Transport Focus	government/organisations/transport-focus	Executive non-departmental public body		
treasure-valuation-committee	Treasure Valuation Committee	government/organisations/treasure-valuation-committee	Advisory non-departmental public body		
treasury-solicitor-s-department	Treasury SolicitorÕs Department	government/organisations/treasury-solicitor-s-department	Non-ministerial department		
tribunal-procedure-committee	Tribunal Procedure Committee	government/organisations/tribunal-procedure-committee	Advisory non-departmental public body		
trinity-house	Trinity House	government/organisations/trinity-house	Executive non-departmental public body		
trust-ports	Trust ports	government/organisations/trust-ports	Other		closed
uk-anti-doping	UK Anti-Doping	government/organisations/uk-anti-doping	Executive non-departmental public body		
uk-atomic-energy-authority	UK Atomic Energy Authority	government/organisations/uk-atomic-energy-authority	Executive non-departmental public body		
uk-border-agency	UK Border Agency	government/organisations/uk-border-agency	Executive agency		
uk-co-ordinating-body	UK Co-ordinating Body	government/organisations/uk-co-ordinating-body	Other		
uk-commission-for-employment-and-skills	UK Commission for Employment and Skills	government/organisations/uk-commission-for-employment-and-skills	Executive non-departmental public body		
uk-debt-management-office	UK Debt Management Office	government/organisations/uk-debt-management-office	Executive agency		
uk-export-finance	UK Export Finance	government/organisations/uk-export-finance	Ministerial department		
uk-film-council	UK Film Council	government/organisations/uk-film-council	Other		31/03/2012
uk-financial-investments-limited	UK Financial Investments Limited	government/organisations/uk-financial-investments-limited	Other		
uk-government-decontamination-service	UK Government Decontamination Service	government/organisations/uk-government-decontamination-service	Sub-organisation		
uk-government-investments	UK Government Investments	government/organisations/uk-government-investments	Other		
uk-green-investment-bank	UK Green Investment Bank	government/organisations/uk-green-investment-bank	Other		
uk-holocaust-memorial-foundation	UK Holocaust Memorial Foundation	government/organisations/uk-holocaust-memorial-foundation	Advisory non-departmental public body		
uk-hydrographic-office	UK Hydrographic Office	government/organisations/uk-hydrographic-office	Executive agency		
uk-passport-service	UK Passport Service	government/organisations/uk-passport-service	Other		01/04/2006
uk-space-agency	UK Space Agency	government/organisations/uk-space-agency	Executive agency		
uk-sport	UK Sport	government/organisations/uk-sport	Executive non-departmental public body		
uk-statistics-authority	UK Statistics Authority	government/organisations/uk-statistics-authority	Non-ministerial department		
uk-trade-and-investment-defence-and-security-organisation	Department for International Trade Defence & Security Organisation	government/organisations/uk-trade-and-investment-defence-and-security-organisation	Sub-organisation		
uk-trade-investment	UK Trade & Investment	government/organisations/uk-trade-investment	Non-ministerial department		13/07/2016
uk-transplant	UK Transplant	government/organisations/uk-transplant	Other		01/10/2005
uk-visas-and-immigration	UK Visas and Immigration	government/organisations/uk-visas-and-immigration	Sub-organisation		
ukti-education	UKTI Education	government/organisations/ukti-education	Sub-organisation		
ukti-life-sciences-organisation	UKTI Life Sciences Organisation	government/organisations/ukti-life-sciences-organisation	Sub-organisation		
united-kingdom-blood-transfusion-services	United Kingdom Blood Transfusion Services	government/organisations/united-kingdom-blood-transfusion-services	Other		closed
united-kingdom-reserve-forces-association	United Kingdom Reserve Forces Association	government/organisations/united-kingdom-reserve-forces-association	Other		
upper-tribunal-administrative-appeals-chamber	Upper Tribunal (Administrative Appeals Chamber)	courts-tribunals/upper-tribunal-administrative-appeals-chamber	Tribunal non-departmental public body		
upper-tribunal-immigration-and-asylum-chamber	Upper Tribunal (Immigration and Asylum Chamber)	courts-tribunals/upper-tribunal-immigration-and-asylum-chamber	Tribunal non-departmental public body		
upper-tribunal-lands-chamber	Upper Tribunal (Lands Chamber)	courts-tribunals/upper-tribunal-lands-chamber	Tribunal non-departmental public body		
upper-tribunal-tax-and-chancery-chamber	Upper Tribunal (Tax and Chancery Chamber)	courts-tribunals/upper-tribunal-tax-and-chancery-chamber	Tribunal non-departmental public body		
valuation-and-lands-agency	Valuation and Lands Agency	government/organisations/valuation-and-lands-agency	Executive agency		
valuation-office-agency	Valuation Office Agency	government/organisations/valuation-office-agency	Executive agency		
valuation-tribunal-for-england	Valuation Tribunal for England	government/organisations/valuation-tribunal-for-england	Tribunal non-departmental public body		
valuation-tribunal-service-for-england-valuation-tribunal-service	Valuation Tribunal Service	government/organisations/valuation-tribunal-service-for-england-valuation-tribunal-service	Executive non-departmental public body		
varney-review	Varney Review	government/organisations/varney-review	Other		06/12/2016
vehicle-and-operator-services-agency	Vehicle and Operator Services Agency	government/organisations/vehicle-and-operator-services-agency	Executive agency		01/04/2014
vehicle-certification-agency	Vehicle Certification Agency	government/organisations/vehicle-certification-agency	Executive agency		
veterans-advisory-and-pensions-committees-x13	Veterans Advisory and Pensions Committees	government/organisations/veterans-advisory-and-pensions-committees-x13	Advisory non-departmental public body		
veterans-uk	Veterans UK	government/organisations/veterans-uk	Sub-organisation		
veterinary-laboratories-agency	Veterinary Laboratories Agency	government/organisations/veterinary-laboratories-agency	Executive agency		01/04/2011
veterinary-medicines-directorate	Veterinary Medicines Directorate	government/organisations/veterinary-medicines-directorate	Executive agency		
veterinary-products-committee	Veterinary Products Committee	government/organisations/veterinary-products-committee	Advisory non-departmental public body		
veterinary-residues-committee	Veterinary Residues Committee	government/organisations/veterinary-residues-committee	Other		2015-01
victim-s-advisory-panel	Victims' Advisory Panel	government/organisations/victim-s-advisory-panel	Advisory non-departmental public body		24/07/2013
victims-commissioner	Victims' Commissioner	government/organisations/victims-commissioner	Other		
victoria-and-albert-museum	Victoria and Albert Museum	government/organisations/victoria-and-albert-museum	Executive non-departmental public body		
victoria-climbi_-inquiry	Victoria Climbi Inquiry	government/organisations/victoria-climbi_-inquiry	Other		28/01/2003
visitbritain	VisitBritain	government/organisations/visitbritain	Executive non-departmental public body		
visitengland	VisitEngland	government/organisations/visitengland	Executive non-departmental public body		
wakefield-education-action-zone	Wakefield Education Action Zone	government/organisations/wakefield-education-action-zone	Other		09/01/2005
wales-audit-office	Wales Audit Office	government/organisations/wales-audit-office	Other		
wales-office	Wales Office	government/organisations/wales-office	Ministerial department		
wallace-collection	Wallace Collection	government/organisations/wallace-collection	Executive non-departmental public body		
warship-support-agency	Warship Support Agency	government/organisations/warship-support-agency	Executive agency		01/04/2005
water-service-northern-ireland	Water Service (Northern Ireland)	government/organisations/water-service-northern-Ireland	Executive agency		
waterways-ireland	Waterways Ireland	government/organisations/waterways-Ireland	Other		
wave-hub	Wave Hub	government/organisations/wave-hub	Other		
wednesbury-education-action-zone	Wednesbury Education Action Zone	government/organisations/wednesbury-education-action-zone	Other		30/11/2004
welsh-development-agency	Welsh Development Agency	government/organisations/welsh-development-agency	Other		01/04/2006
welsh-government	Welsh Government	government/organisations/welsh-government	Devolved administration		
welsh-language-commissioner	Welsh Language Commissioner	government/organisations/welsh-language-commissioner	Other		
welsh-office	Welsh Office	government/organisations/welsh-office	Other		01/07/1999
western-education-and-library-board	Western Education and Library Board	government/organisations/western-education-and-library-board	Other		
western-health-and-social-services-board	Western Health and Social Services Board	government/organisations/western-health-and-social-services-board	Other		
westminster-education-action-zone	Westminster Education Action Zone	government/organisations/westminster-education-action-zone	Other		30/04/2005
westminster-foundation-for-democracy	Westminster Foundation for Democracy	government/organisations/westminster-foundation-for-democracy	Executive non-departmental public body		
wilton-park	Wilton Park	government/organisations/wilton-park	Executive agency		
withernsea-and-southern-holderness-education-action-zone	Withernsea and Southern Holderness Education Action Zone	government/organisations/withernsea-and-southern-holderness-education-action-zone	Other		09/01/2005
wolverhampton-education-action-zone	Wolverhampton Education Action Zone	government/organisations/wolverhampton-education-action-zone	Other		09/01/2005
working-ventures-uk	Working Ventures UK	government/organisations/working-ventures-uk	Other		02/10/2009
wythenshawe-education-action-zone	Wythenshawe Education Action Zone	government/organisations/wythenshawe-education-action-zone	Other		30/11/2004
yorkshire-dales-national-park-authority	Yorkshire Dales National Park Authority	government/organisations/yorkshire-dales-national-park-authority	Other		
yorkshire-forward	Yorkshire Forward	government/organisations/yorkshire-forward	Executive agency		30/06/2012
young-peoples-learning-agency	Young People's Learning Agency	government/organisations/young-peoples-learning-agency	Executive agency		31/03/2012
youth-justice-agency-of-northern-ireland	Youth Justice Agency of Northern Ireland	government/organisations/youth-justice-agency-of-northern-Ireland	Executive agency		
youth-justice-board-for-england-and-wales	Youth Justice Board for England and Wales	government/organisations/youth-justice-board-for-england-and-wales	Executive non-departmental public body		
zahid-mubarek-inquiry	Zahid Mubarek Inquiry	government/organisations/zahid-mubarek-inquiry	Other		29/06/2006
					
					
